scode,unique_id,ccode,state_name,year,region,pitf_sf,pitf_effect,pitf_legit,hs_fragility
ARM,371.1995,371,Armenia,1995,5,8,7,1,-0.489199996
ARM,371.1996,371,Armenia,1996,5,7,7,0,-0.413700014
ARM,371.1997,371,Armenia,1997,5,8,7,1,-0.412800014
ARM,371.1998,371,Armenia,1998,5,8,7,1,-0.399699986
ARM,371.1999,371,Armenia,1999,5,8,7,1,-0.521000028
ARM,371.2,371,Armenia,2000,5,8,7,1,-0.41870001
ARM,371.2001,371,Armenia,2001,5,9,7,2,-0.423200011
ARM,371.2002,371,Armenia,2002,5,7,6,1,-0.456800014
ARM,371.2003,371,Armenia,2003,5,7,5,2,-0.462900013
ARM,371.2004,371,Armenia,2004,5,7,5,2,-0.584800005
ARM,371.2005,371,Armenia,2005,5,7,5,2,-0.741100013
ARM,371.2006,371,Armenia,2006,5,7,4,3,-0.797399998
ARM,371.2007,371,Armenia,2007,5,6,4,2,-0.854099989
ARM,371.2008,371,Armenia,2008,5,6,3,3,-0.915099978
ARM,371.2009,371,Armenia,2009,5,7,3,4,-0.918299973
ARM,371.201,371,Armenia,2010,5,7,3,4,-0.904600024
ARM,371.2011,371,Armenia,2011,5,7,3,4,-0.869400024
ARM,371.2012,371,Armenia,2012,5,7,3,4,-0.8125
ARM,371.2013,371,Armenia,2013,5,7,3,4,-0.849399984
ARM,371.2014,371,Armenia,2014,5,7,3,4,-0.992500007
ARM,371.2015,371,Armenia,2015,5,6,2,4,-1.07099998
ARM,371.2016,371,Armenia,2016,5,6,2,4,NA
ARM,371.2017,371,Armenia,2017,5,6,2,4,NA
ARM,371.2018,371,Armenia,2018,5,6,3,3,NA
BFO,439.1995,439,Burkina Faso,1995,1,16,9,7,-0.03576
BFO,439.1996,439,Burkina Faso,1996,1,16,9,7,-0.075620003
BFO,439.1997,439,Burkina Faso,1997,1,14,8,6,-0.072930001
BFO,439.1998,439,Burkina Faso,1998,1,14,8,6,-0.092380002
BFO,439.1999,439,Burkina Faso,1999,1,14,8,6,-0.185200006
BFO,439.2,439,Burkina Faso,2000,1,15,9,6,-0.231099993
BFO,439.2001,439,Burkina Faso,2001,1,17,10,7,-0.210700005
BFO,439.2002,439,Burkina Faso,2002,1,15,9,6,-0.163499996
BFO,439.2003,439,Burkina Faso,2003,1,17,10,7,-0.157199994
BFO,439.2004,439,Burkina Faso,2004,1,16,10,6,-0.165700004
BFO,439.2005,439,Burkina Faso,2005,1,17,10,7,-0.219600007
BFO,439.2006,439,Burkina Faso,2006,1,17,10,7,-0.288399994
BFO,439.2007,439,Burkina Faso,2007,1,17,10,7,-0.275700003
BFO,439.2008,439,Burkina Faso,2008,1,17,10,7,-0.263500005
BFO,439.2009,439,Burkina Faso,2009,1,17,10,7,-0.236499995
BFO,439.201,439,Burkina Faso,2010,1,17,10,7,-0.228
BFO,439.2011,439,Burkina Faso,2011,1,16,9,7,-0.261599988
BFO,439.2012,439,Burkina Faso,2012,1,16,9,7,-0.278400004
BFO,439.2013,439,Burkina Faso,2013,1,15,8,7,-0.329100013
BFO,439.2014,439,Burkina Faso,2014,1,14,7,7,-0.254299998
BFO,439.2015,439,Burkina Faso,2015,1,16,9,7,-0.168300003
BFO,439.2016,439,Burkina Faso,2016,1,16,9,7,NA
BFO,439.2017,439,Burkina Faso,2017,1,15,8,7,NA
BFO,439.2018,439,Burkina Faso,2018,1,16,9,7,NA
BHU,760.1995,760,Bhutan,1995,3,17,8,9,-0.488900006
BHU,760.1996,760,Bhutan,1996,3,15,8,7,-0.612399995
BHU,760.1997,760,Bhutan,1997,3,16,8,8,-0.614199996
BHU,760.1998,760,Bhutan,1998,3,13,7,6,-0.513599992
BHU,760.1999,760,Bhutan,1999,3,14,7,7,-0.523699999
BHU,760.2,760,Bhutan,2000,3,14,7,7,-0.686500013
BHU,760.2001,760,Bhutan,2001,3,13,6,7,-0.680899978
BHU,760.2002,760,Bhutan,2002,3,13,6,7,-0.690800011
BHU,760.2003,760,Bhutan,2003,3,13,6,7,-0.557099998
BHU,760.2004,760,Bhutan,2004,3,12,5,7,-0.581900001
BHU,760.2005,760,Bhutan,2005,3,13,6,7,-0.392800003
BHU,760.2006,760,Bhutan,2006,3,11,5,6,-0.475499988
BHU,760.2007,760,Bhutan,2007,3,11,5,6,-0.42840001
BHU,760.2008,760,Bhutan,2008,3,10,5,5,-0.569000006
BHU,760.2009,760,Bhutan,2009,3,10,5,5,-0.699599981
BHU,760.201,760,Bhutan,2010,3,10,5,5,-0.718699992
BHU,760.2011,760,Bhutan,2011,3,8,5,3,-0.737299979
BHU,760.2012,760,Bhutan,2012,3,8,5,3,-0.672399998
BHU,760.2013,760,Bhutan,2013,3,8,5,3,-0.6875
BHU,760.2014,760,Bhutan,2014,3,8,5,3,-0.771099985
BHU,760.2015,760,Bhutan,2015,3,7,4,3,-0.627499998
BHU,760.2016,760,Bhutan,2016,3,7,4,3,NA
BHU,760.2017,760,Bhutan,2017,3,7,4,3,NA
BHU,760.2018,760,Bhutan,2018,3,6,3,3,NA
BNG,771.1995,771,Bangladesh,1995,2,20,12,8,0.194800004
BNG,771.1996,771,Bangladesh,1996,2,20,12,8,0.183599994
BNG,771.1997,771,Bangladesh,1997,2,18,11,7,0.164900005
BNG,771.1998,771,Bangladesh,1998,2,17,11,6,0.087619998
BNG,771.1999,771,Bangladesh,1999,2,17,11,6,0.114600003
BNG,771.2,771,Bangladesh,2000,2,17,11,6,0.232600003
BNG,771.2001,771,Bangladesh,2001,2,15,9,6,0.34709999
BNG,771.2002,771,Bangladesh,2002,2,14,8,6,0.414700001
BNG,771.2003,771,Bangladesh,2003,2,14,8,6,0.398999989
BNG,771.2004,771,Bangladesh,2004,2,14,8,6,0.277700007
BNG,771.2005,771,Bangladesh,2005,2,13,7,6,0.181700006
BNG,771.2006,771,Bangladesh,2006,2,13,7,6,0.05711
BNG,771.2007,771,Bangladesh,2007,2,14,8,6,0.017510001
BNG,771.2008,771,Bangladesh,2008,2,13,8,5,0.085419998
BNG,771.2009,771,Bangladesh,2009,2,12,7,5,0.152500004
BNG,771.201,771,Bangladesh,2010,2,12,7,5,0.074029997
BNG,771.2011,771,Bangladesh,2011,2,12,7,5,0.079669997
BNG,771.2012,771,Bangladesh,2012,2,12,7,5,0.106600001
BNG,771.2013,771,Bangladesh,2013,2,13,7,6,0.174199998
BNG,771.2014,771,Bangladesh,2014,2,13,7,6,0.004775
BNG,771.2015,771,Bangladesh,2015,2,12,7,5,-0.01227
BNG,771.2016,771,Bangladesh,2016,2,12,7,5,NA
BNG,771.2017,771,Bangladesh,2017,2,11,6,5,NA
BNG,771.2018,771,Bangladesh,2018,2,11,7,4,NA
BOT,571.1995,571,Botswana,1995,1,7,4,3,-0.774399996
BOT,571.1996,571,Botswana,1996,1,7,4,3,-0.673500001
BOT,571.1997,571,Botswana,1997,1,7,4,3,-0.673699975
BOT,571.1998,571,Botswana,1998,1,6,3,3,-0.747099996
BOT,571.1999,571,Botswana,1999,1,6,3,3,-0.753000021
BOT,571.2,571,Botswana,2000,1,6,3,3,-0.773400009
BOT,571.2001,571,Botswana,2001,1,6,3,3,-0.863499999
BOT,571.2002,571,Botswana,2002,1,6,3,3,-0.994400024
BOT,571.2003,571,Botswana,2003,1,6,3,3,-0.995500028
BOT,571.2004,571,Botswana,2004,1,6,3,3,-0.846899986
BOT,571.2005,571,Botswana,2005,1,6,3,3,-0.891099989
BOT,571.2006,571,Botswana,2006,1,3,2,1,-0.789799988
BOT,571.2007,571,Botswana,2007,1,3,2,1,-0.819700003
BOT,571.2008,571,Botswana,2008,1,3,2,1,-0.845799983
BOT,571.2009,571,Botswana,2009,1,3,2,1,-0.815100014
BOT,571.201,571,Botswana,2010,1,3,2,1,-0.750800014
BOT,571.2011,571,Botswana,2011,1,3,2,1,-0.777499974
BOT,571.2012,571,Botswana,2012,1,3,2,1,-0.641600013
BOT,571.2013,571,Botswana,2013,1,3,2,1,-0.618499994
BOT,571.2014,571,Botswana,2014,1,3,2,1,-0.547599971
BOT,571.2015,571,Botswana,2015,1,3,2,1,-0.621299982
BOT,571.2016,571,Botswana,2016,1,3,2,1,NA
BOT,571.2017,571,Botswana,2017,1,3,1,2,NA
BOT,571.2018,571,Botswana,2018,1,3,1,2,NA
BRA,140.1995,140,Brazil,1995,4,7,2,5,-0.979799986
BRA,140.1996,140,Brazil,1996,4,6,2,4,-1.01699996
BRA,140.1997,140,Brazil,1997,4,6,2,4,-0.940800011
BRA,140.1998,140,Brazil,1998,4,6,2,4,-0.835699975
BRA,140.1999,140,Brazil,1999,4,6,2,4,-0.808799982
BRA,140.2,140,Brazil,2000,4,6,2,4,-0.794700027
BRA,140.2001,140,Brazil,2001,4,6,2,4,-0.797399998
BRA,140.2002,140,Brazil,2002,4,6,2,4,-0.778999984
BRA,140.2003,140,Brazil,2003,4,6,2,4,-0.735400021
BRA,140.2004,140,Brazil,2004,4,6,2,4,-0.897599995
BRA,140.2005,140,Brazil,2005,4,6,2,4,-1.034999967
BRA,140.2006,140,Brazil,2006,4,6,2,4,-0.986500025
BRA,140.2007,140,Brazil,2007,4,5,1,4,-0.977800012
BRA,140.2008,140,Brazil,2008,4,5,1,4,-0.928600013
BRA,140.2009,140,Brazil,2009,4,5,1,4,-0.921999991
BRA,140.201,140,Brazil,2010,4,6,1,5,-0.900200009
BRA,140.2011,140,Brazil,2011,4,6,1,5,-0.922900021
BRA,140.2012,140,Brazil,2012,4,6,1,5,-0.849699974
BRA,140.2013,140,Brazil,2013,4,5,1,4,-0.823199987
BRA,140.2014,140,Brazil,2014,4,5,1,4,-0.805400014
BRA,140.2015,140,Brazil,2015,4,5,1,4,-0.738200009
BRA,140.2016,140,Brazil,2016,4,6,2,4,NA
BRA,140.2017,140,Brazil,2017,4,6,2,4,NA
BRA,140.2018,140,Brazil,2018,4,6,2,4,NA
CAM,811.1995,811,Cambodia,1995,3,17,12,5,1.302999973
CAM,811.1996,811,Cambodia,1996,3,17,12,5,1.243000031
CAM,811.1997,811,Cambodia,1997,3,16,12,4,1.180999994
CAM,811.1998,811,Cambodia,1998,3,16,12,4,1.144000053
CAM,811.1999,811,Cambodia,1999,3,16,12,4,1.036999941
CAM,811.2,811,Cambodia,2000,3,15,11,4,0.787899971
CAM,811.2001,811,Cambodia,2001,3,15,11,4,0.766499996
CAM,811.2002,811,Cambodia,2002,3,14,11,3,0.75120002
CAM,811.2003,811,Cambodia,2003,3,15,11,4,0.689800024
CAM,811.2004,811,Cambodia,2004,3,14,11,3,0.506500006
CAM,811.2005,811,Cambodia,2005,3,14,11,3,0.547900021
CAM,811.2006,811,Cambodia,2006,3,13,10,3,0.392699987
CAM,811.2007,811,Cambodia,2007,3,14,10,4,0.351700008
CAM,811.2008,811,Cambodia,2008,3,13,9,4,0.312999994
CAM,811.2009,811,Cambodia,2009,3,12,8,4,0.2289
CAM,811.201,811,Cambodia,2010,3,12,8,4,0.211600006
CAM,811.2011,811,Cambodia,2011,3,10,7,3,0.155699998
CAM,811.2012,811,Cambodia,2012,3,10,7,3,0.199399993
CAM,811.2013,811,Cambodia,2013,3,11,7,4,0.160500005
CAM,811.2014,811,Cambodia,2014,3,11,7,4,0.073579997
CAM,811.2015,811,Cambodia,2015,3,11,7,4,0.055119999
CAM,811.2016,811,Cambodia,2016,3,11,6,5,NA
CAM,811.2017,811,Cambodia,2017,3,10,7,3,NA
CAM,811.2018,811,Cambodia,2018,3,10,7,3,NA
CHA,483.1995,483,Chad,1995,2,22,12,10,0.837800026
CHA,483.1996,483,Chad,1996,2,22,12,10,0.832799971
CHA,483.1997,483,Chad,1997,2,22,12,10,0.865400016
CHA,483.1998,483,Chad,1998,2,22,12,10,0.917800009
CHA,483.1999,483,Chad,1999,2,22,12,10,0.83099997
CHA,483.2,483,Chad,2000,2,22,12,10,0.840600014
CHA,483.2001,483,Chad,2001,2,22,12,10,0.840900004
CHA,483.2002,483,Chad,2002,2,21,11,10,0.720600009
CHA,483.2003,483,Chad,2003,2,22,12,10,0.668799996
CHA,483.2004,483,Chad,2004,2,21,11,10,0.591799974
CHA,483.2005,483,Chad,2005,2,21,11,10,0.691200018
CHA,483.2006,483,Chad,2006,2,20,11,9,0.717100024
CHA,483.2007,483,Chad,2007,2,20,11,9,0.931800008
CHA,483.2008,483,Chad,2008,2,21,11,10,0.994799972
CHA,483.2009,483,Chad,2009,2,21,11,10,0.882000029
CHA,483.201,483,Chad,2010,2,21,11,10,0.854600012
CHA,483.2011,483,Chad,2011,2,21,11,10,0.940999985
CHA,483.2012,483,Chad,2012,2,20,11,9,0.803499997
CHA,483.2013,483,Chad,2013,2,19,10,9,0.618099988
CHA,483.2014,483,Chad,2014,2,19,10,9,0.587199986
CHA,483.2015,483,Chad,2015,2,19,10,9,0.53490001
CHA,483.2016,483,Chad,2016,2,19,10,9,NA
CHA,483.2017,483,Chad,2017,2,18,9,9,NA
CHA,483.2018,483,Chad,2018,2,19,10,9,NA
COL,100.1995,100,Colombia,1995,4,13,4,9,-0.363700002
COL,100.1996,100,Colombia,1996,4,13,4,9,-0.392100006
COL,100.1997,100,Colombia,1997,4,13,4,9,-0.342900008
COL,100.1998,100,Colombia,1998,4,13,4,9,-0.280499995
COL,100.1999,100,Colombia,1999,4,14,5,9,-0.271299988
COL,100.2,100,Colombia,2000,4,13,4,9,-0.166600004
COL,100.2001,100,Colombia,2001,4,13,4,9,-0.213100001
COL,100.2002,100,Colombia,2002,4,13,4,9,-0.301200002
COL,100.2003,100,Colombia,2003,4,13,4,9,-0.210999995
COL,100.2004,100,Colombia,2004,4,13,4,9,-0.428499997
COL,100.2005,100,Colombia,2005,4,13,4,9,-0.440699995
COL,100.2006,100,Colombia,2006,4,12,4,8,-0.194999993
COL,100.2007,100,Colombia,2007,4,12,4,8,-0.390300006
COL,100.2008,100,Colombia,2008,4,12,4,8,-0.456400007
COL,100.2009,100,Colombia,2009,4,11,3,8,-0.533599973
COL,100.201,100,Colombia,2010,4,11,3,8,-0.487899989
COL,100.2011,100,Colombia,2011,4,11,3,8,-0.560199976
COL,100.2012,100,Colombia,2012,4,10,3,7,-0.6329
COL,100.2013,100,Colombia,2013,4,9,3,6,-0.607200027
COL,100.2014,100,Colombia,2014,4,9,3,6,-0.609000027
COL,100.2015,100,Colombia,2015,4,10,3,7,-0.618099988
COL,100.2016,100,Colombia,2016,4,10,3,7,NA
COL,100.2017,100,Colombia,2017,4,11,3,8,NA
COL,100.2018,100,Colombia,2018,4,11,3,8,NA
COS,94.1995,94,Costa Rica,1995,4,3,1,2,-0.619899988
COS,94.1996,94,Costa Rica,1996,4,3,1,2,-0.69599998
COS,94.1997,94,Costa Rica,1997,4,1,1,0,-0.711499989
COS,94.1998,94,Costa Rica,1998,4,1,1,0,-0.720200002
COS,94.1999,94,Costa Rica,1999,4,1,1,0,-0.771600008
COS,94.2,94,Costa Rica,2000,4,1,1,0,-0.884800017
COS,94.2001,94,Costa Rica,2001,4,1,1,0,-0.936600029
COS,94.2002,94,Costa Rica,2002,4,1,1,0,-0.872500002
COS,94.2003,94,Costa Rica,2003,4,1,1,0,-0.891099989
COS,94.2004,94,Costa Rica,2004,4,1,1,0,-0.925499976
COS,94.2005,94,Costa Rica,2005,4,1,1,0,-0.794700027
COS,94.2006,94,Costa Rica,2006,4,1,1,0,-0.926599979
COS,94.2007,94,Costa Rica,2007,4,1,1,0,-0.921599984
COS,94.2008,94,Costa Rica,2008,4,1,1,0,-0.884000003
COS,94.2009,94,Costa Rica,2009,4,1,1,0,-0.88380003
COS,94.201,94,Costa Rica,2010,4,1,1,0,-0.795799971
COS,94.2011,94,Costa Rica,2011,4,1,1,0,-0.833500028
COS,94.2012,94,Costa Rica,2012,4,1,1,0,-0.833700001
COS,94.2013,94,Costa Rica,2013,4,1,1,0,-0.818899989
COS,94.2014,94,Costa Rica,2014,4,1,1,0,-0.800300002
COS,94.2015,94,Costa Rica,2015,4,1,1,0,-0.869599998
COS,94.2016,94,Costa Rica,2016,4,1,1,0,NA
COS,94.2017,94,Costa Rica,2017,4,1,1,0,NA
COS,94.2018,94,Costa Rica,2018,4,1,1,0,NA
ETI,530.1995,530,Ethiopia,1995,1,20,11,9,NA
ETI,530.1996,530,Ethiopia,1996,1,18,9,9,NA
ETI,530.1997,530,Ethiopia,1997,1,19,9,10,NA
ETI,530.1998,530,Ethiopia,1998,1,19,9,10,NA
ETI,530.1999,530,Ethiopia,1999,1,21,11,10,NA
ETI,530.2,530,Ethiopia,2000,1,21,11,10,NA
ETI,530.2001,530,Ethiopia,2001,1,20,11,9,NA
ETI,530.2002,530,Ethiopia,2002,1,20,11,9,NA
ETI,530.2003,530,Ethiopia,2003,1,21,11,10,NA
ETI,530.2004,530,Ethiopia,2004,1,21,11,10,NA
ETI,530.2005,530,Ethiopia,2005,1,20,10,10,NA
ETI,530.2006,530,Ethiopia,2006,1,20,10,10,NA
ETI,530.2007,530,Ethiopia,2007,1,20,10,10,NA
ETI,530.2008,530,Ethiopia,2008,1,19,10,9,NA
ETI,530.2009,530,Ethiopia,2009,1,20,11,9,NA
ETI,530.201,530,Ethiopia,2010,1,20,11,9,NA
ETI,530.2011,530,Ethiopia,2011,1,20,11,9,NA
ETI,530.2012,530,Ethiopia,2012,1,20,11,9,NA
ETI,530.2013,530,Ethiopia,2013,1,19,10,9,NA
ETI,530.2014,530,Ethiopia,2014,1,20,10,10,NA
ETI,530.2015,530,Ethiopia,2015,1,19,9,10,NA
ETI,530.2016,530,Ethiopia,2016,1,19,9,10,NA
ETI,530.2017,530,Ethiopia,2017,1,19,9,10,NA
ETI,530.2018,530,Ethiopia,2018,1,20,10,10,NA
GAB,481.1995,481,Gabon,1995,1,12,5,7,-0.080700003
GAB,481.1996,481,Gabon,1996,1,12,5,7,-0.05762
GAB,481.1997,481,Gabon,1997,1,11,4,7,-0.076909997
GAB,481.1998,481,Gabon,1998,1,11,4,7,-0.074929997
GAB,481.1999,481,Gabon,1999,1,11,5,6,-0.1426
GAB,481.2,481,Gabon,2000,1,12,5,7,0.074019998
GAB,481.2001,481,Gabon,2001,1,10,4,6,0.023709999
GAB,481.2002,481,Gabon,2002,1,10,4,6,-0.063699998
GAB,481.2003,481,Gabon,2003,1,11,4,7,-0.071099997
GAB,481.2004,481,Gabon,2004,1,11,4,7,0.217099994
GAB,481.2005,481,Gabon,2005,1,11,4,7,0.329400003
GAB,481.2006,481,Gabon,2006,1,11,4,7,0.423000008
GAB,481.2007,481,Gabon,2007,1,10,3,7,0.430400014
GAB,481.2008,481,Gabon,2008,1,10,3,7,0.342500001
GAB,481.2009,481,Gabon,2009,1,11,3,8,0.185499996
GAB,481.201,481,Gabon,2010,1,11,3,8,0.271800011
GAB,481.2011,481,Gabon,2011,1,11,3,8,0.125799999
GAB,481.2012,481,Gabon,2012,1,11,3,8,0.289299995
GAB,481.2013,481,Gabon,2013,1,11,3,8,0.160400003
GAB,481.2014,481,Gabon,2014,1,10,3,7,0.156800002
GAB,481.2015,481,Gabon,2015,1,10,3,7,0.208900005
GAB,481.2016,481,Gabon,2016,1,10,3,7,NA
GAB,481.2017,481,Gabon,2017,1,8,2,6,NA
GAB,481.2018,481,Gabon,2018,1,8,2,6,NA
GAM,420.1995,420,Gambia,1995,2,14,10,4,0.263500005
GAM,420.1996,420,Gambia,1996,2,14,9,5,0.191100001
GAM,420.1997,420,Gambia,1997,2,14,9,5,0.142399997
GAM,420.1998,420,Gambia,1998,2,16,9,7,0.172700003
GAM,420.1999,420,Gambia,1999,2,15,9,6,0.163100004
GAM,420.2,420,Gambia,2000,2,15,9,6,0.1954
GAM,420.2001,420,Gambia,2001,2,15,9,6,0.197799996
GAM,420.2002,420,Gambia,2002,2,13,9,4,0.221200004
GAM,420.2003,420,Gambia,2003,2,13,9,4,0.306100011
GAM,420.2004,420,Gambia,2004,2,12,9,3,0.260600001
GAM,420.2005,420,Gambia,2005,2,12,9,3,0.247099996
GAM,420.2006,420,Gambia,2006,2,15,10,5,0.186000004
GAM,420.2007,420,Gambia,2007,2,15,10,5,0.122599997
GAM,420.2008,420,Gambia,2008,2,14,9,5,0.047389999
GAM,420.2009,420,Gambia,2009,2,13,8,5,0.179499999
GAM,420.201,420,Gambia,2010,2,14,9,5,-0.024250001
GAM,420.2011,420,Gambia,2011,2,14,9,5,0.025040001
GAM,420.2012,420,Gambia,2012,2,14,9,5,-0.01047
GAM,420.2013,420,Gambia,2013,2,15,9,6,0.073299997
GAM,420.2014,420,Gambia,2014,2,15,9,6,0.066459998
GAM,420.2015,420,Gambia,2015,2,15,9,6,0.1567
GAM,420.2016,420,Gambia,2016,2,15,9,6,NA
GAM,420.2017,420,Gambia,2017,2,15,9,6,NA
GAM,420.2018,420,Gambia,2018,2,15,9,6,NA
GHA,452.1995,452,Ghana,1995,1,16,9,7,0.230000004
GHA,452.1996,452,Ghana,1996,1,15,9,6,0.211600006
GHA,452.1997,452,Ghana,1997,1,14,9,5,0.219899997
GHA,452.1998,452,Ghana,1998,1,14,9,5,0.231900007
GHA,452.1999,452,Ghana,1999,1,13,8,5,0.215399995
GHA,452.2,452,Ghana,2000,1,12,7,5,0.337500006
GHA,452.2001,452,Ghana,2001,1,11,7,4,0.484899998
GHA,452.2002,452,Ghana,2002,1,12,7,5,0.403200001
GHA,452.2003,452,Ghana,2003,1,13,7,6,0.275400013
GHA,452.2004,452,Ghana,2004,1,14,8,6,0.367700011
GHA,452.2005,452,Ghana,2005,1,12,7,5,0.089120001
GHA,452.2006,452,Ghana,2006,1,13,7,6,-0.050810002
GHA,452.2007,452,Ghana,2007,1,13,7,6,-0.072999999
GHA,452.2008,452,Ghana,2008,1,13,7,6,-0.089670002
GHA,452.2009,452,Ghana,2009,1,13,7,6,-0.089639999
GHA,452.201,452,Ghana,2010,1,12,7,5,-0.144099995
GHA,452.2011,452,Ghana,2011,1,11,6,5,-0.152999997
GHA,452.2012,452,Ghana,2012,1,10,6,4,-0.221699998
GHA,452.2013,452,Ghana,2013,1,11,6,5,-0.149000004
GHA,452.2014,452,Ghana,2014,1,10,5,5,-0.1219
GHA,452.2015,452,Ghana,2015,1,11,6,5,-0.254999995
GHA,452.2016,452,Ghana,2016,1,11,6,5,NA
GHA,452.2017,452,Ghana,2017,1,11,6,5,NA
GHA,452.2018,452,Ghana,2018,1,11,6,5,NA
GNB,404.1995,404,Guinea-Bissau,1995,1,17,10,7,1.037999988
GNB,404.1996,404,Guinea-Bissau,1996,1,16,10,6,1.095000029
GNB,404.1997,404,Guinea-Bissau,1997,1,16,10,6,1.098999977
GNB,404.1998,404,Guinea-Bissau,1998,1,19,11,8,1.049000025
GNB,404.1999,404,Guinea-Bissau,1999,1,20,11,9,1.008999944
GNB,404.2,404,Guinea-Bissau,2000,1,19,11,8,0.896000028
GNB,404.2001,404,Guinea-Bissau,2001,1,19,11,8,0.890200019
GNB,404.2002,404,Guinea-Bissau,2002,1,19,11,8,0.927699983
GNB,404.2003,404,Guinea-Bissau,2003,1,18,10,8,0.848500013
GNB,404.2004,404,Guinea-Bissau,2004,1,18,10,8,0.886300027
GNB,404.2005,404,Guinea-Bissau,2005,1,18,10,8,0.891600013
GNB,404.2006,404,Guinea-Bissau,2006,1,17,10,7,0.736800015
GNB,404.2007,404,Guinea-Bissau,2007,1,17,10,7,0.794399977
GNB,404.2008,404,Guinea-Bissau,2008,1,17,10,7,0.847599983
GNB,404.2009,404,Guinea-Bissau,2009,1,17,10,7,0.84009999
GNB,404.201,404,Guinea-Bissau,2010,1,17,10,7,0.654799998
GNB,404.2011,404,Guinea-Bissau,2011,1,17,10,7,0.650300026
GNB,404.2012,404,Guinea-Bissau,2012,1,18,10,8,0.711600006
GNB,404.2013,404,Guinea-Bissau,2013,1,18,10,8,0.747900009
GNB,404.2014,404,Guinea-Bissau,2014,1,17,10,7,0.84829998
GNB,404.2015,404,Guinea-Bissau,2015,1,17,10,7,0.860300004
GNB,404.2016,404,Guinea-Bissau,2016,1,17,10,7,NA
GNB,404.2017,404,Guinea-Bissau,2017,1,16,9,7,NA
GNB,404.2018,404,Guinea-Bissau,2018,1,17,10,7,NA
GRG,372.1995,372,Georgia,1995,5,14,8,6,0.504499972
GRG,372.1996,372,Georgia,1996,5,10,7,3,0.643999994
GRG,372.1997,372,Georgia,1997,5,10,7,3,0.689499974
GRG,372.1998,372,Georgia,1998,5,11,7,4,0.589399993
GRG,372.1999,372,Georgia,1999,5,11,7,4,0.556200027
GRG,372.2,372,Georgia,2000,5,12,7,5,0.546199977
GRG,372.2001,372,Georgia,2001,5,11,6,5,0.533299983
GRG,372.2002,372,Georgia,2002,5,11,5,6,0.506900012
GRG,372.2003,372,Georgia,2003,5,11,5,6,0.443899989
GRG,372.2004,372,Georgia,2004,5,9,5,4,-0.240999997
GRG,372.2005,372,Georgia,2005,5,8,4,4,-0.609099984
GRG,372.2006,372,Georgia,2006,5,6,4,2,-0.537500024
GRG,372.2007,372,Georgia,2007,5,8,4,4,-0.706099987
GRG,372.2008,372,Georgia,2008,5,8,5,3,-0.87379998
GRG,372.2009,372,Georgia,2009,5,8,5,3,-0.793799996
GRG,372.201,372,Georgia,2010,5,8,5,3,-0.883899987
GRG,372.2011,372,Georgia,2011,5,8,5,3,-0.915300012
GRG,372.2012,372,Georgia,2012,5,8,5,3,-0.981599987
GRG,372.2013,372,Georgia,2013,5,7,4,3,-1.026000023
GRG,372.2014,372,Georgia,2014,5,7,4,3,-0.776899993
GRG,372.2015,372,Georgia,2015,5,6,3,3,-0.902100027
GRG,372.2016,372,Georgia,2016,5,6,3,3,NA
GRG,372.2017,372,Georgia,2017,5,4,2,2,NA
GRG,372.2018,372,Georgia,2018,5,5,3,2,NA
GUA,90.1995,90,Guatemala,1995,4,20,10,10,0.138600007
GUA,90.1996,90,Guatemala,1996,4,18,10,8,0.04177
GUA,90.1997,90,Guatemala,1997,4,16,10,6,0.008281
GUA,90.1998,90,Guatemala,1998,4,17,10,7,0.114100002
GUA,90.1999,90,Guatemala,1999,4,16,9,7,0.074960001
GUA,90.2,90,Guatemala,2000,4,16,9,7,-0.005787
GUA,90.2001,90,Guatemala,2001,4,16,9,7,-0.02942
GUA,90.2002,90,Guatemala,2002,4,16,9,7,0.01303
GUA,90.2003,90,Guatemala,2003,4,14,8,6,0.02355
GUA,90.2004,90,Guatemala,2004,4,12,8,4,-0.160099998
GUA,90.2005,90,Guatemala,2005,4,13,8,5,-0.286199987
GUA,90.2006,90,Guatemala,2006,4,12,7,5,-0.268599987
GUA,90.2007,90,Guatemala,2007,4,12,7,5,-0.221699998
GUA,90.2008,90,Guatemala,2008,4,11,6,5,-0.229499996
GUA,90.2009,90,Guatemala,2009,4,11,6,5,-0.225700006
GUA,90.201,90,Guatemala,2010,4,10,5,5,-0.235200003
GUA,90.2011,90,Guatemala,2011,4,9,5,4,-0.231700003
GUA,90.2012,90,Guatemala,2012,4,9,5,4,-0.142000005
GUA,90.2013,90,Guatemala,2013,4,7,3,4,-0.220500007
GUA,90.2014,90,Guatemala,2014,4,7,3,4,-0.129899994
GUA,90.2015,90,Guatemala,2015,4,7,3,4,-0.145500004
GUA,90.2016,90,Guatemala,2016,4,8,4,4,NA
GUA,90.2017,90,Guatemala,2017,4,8,4,4,NA
GUA,90.2018,90,Guatemala,2018,4,8,4,4,NA
HON,91.1995,91,Honduras,1995,4,13,7,6,-0.00304
HON,91.1996,91,Honduras,1996,4,10,5,5,-0.005715
HON,91.1997,91,Honduras,1997,4,10,5,5,0.02723
HON,91.1998,91,Honduras,1998,4,10,5,5,0.089709997
HON,91.1999,91,Honduras,1999,4,11,7,4,0.041359998
HON,91.2,91,Honduras,2000,4,10,6,4,0.166600004
HON,91.2001,91,Honduras,2001,4,10,6,4,0.102799997
HON,91.2002,91,Honduras,2002,4,10,5,5,0.092739999
HON,91.2003,91,Honduras,2003,4,10,5,5,0.085620001
HON,91.2004,91,Honduras,2004,4,9,5,4,-0.02744
HON,91.2005,91,Honduras,2005,4,9,5,4,-0.087820001
HON,91.2006,91,Honduras,2006,4,9,5,4,-0.078019999
HON,91.2007,91,Honduras,2007,4,8,4,4,-0.1796
HON,91.2008,91,Honduras,2008,4,8,4,4,-0.159400001
HON,91.2009,91,Honduras,2009,4,9,4,5,-0.209600002
HON,91.201,91,Honduras,2010,4,9,4,5,-0.256700009
HON,91.2011,91,Honduras,2011,4,9,4,5,-0.274899989
HON,91.2012,91,Honduras,2012,4,7,4,3,-0.188899994
HON,91.2013,91,Honduras,2013,4,7,4,3,-0.132400006
HON,91.2014,91,Honduras,2014,4,7,4,3,-0.248099998
HON,91.2015,91,Honduras,2015,4,7,4,3,-0.341800004
HON,91.2016,91,Honduras,2016,4,7,4,3,NA
HON,91.2017,91,Honduras,2017,4,7,4,3,NA
HON,91.2018,91,Honduras,2018,4,7,4,3,NA
IND,750.1995,750,India,1995,3,17,10,7,-0.354900002
IND,750.1996,750,India,1996,3,17,10,7,-0.352699995
IND,750.1997,750,India,1997,3,16,9,7,-0.362899989
IND,750.1998,750,India,1998,3,16,9,7,-0.354000002
IND,750.1999,750,India,1999,3,14,8,6,-0.450599998
IND,750.2,750,India,2000,3,14,8,6,-0.481400013
IND,750.2001,750,India,2001,3,14,8,6,-0.484499991
IND,750.2002,750,India,2002,3,14,8,6,-0.495200008
IND,750.2003,750,India,2003,3,14,8,6,-0.676900029
IND,750.2004,750,India,2004,3,12,8,4,-0.734799981
IND,750.2005,750,India,2005,3,12,8,4,-0.752499998
IND,750.2006,750,India,2006,3,12,8,4,-0.783299983
IND,750.2007,750,India,2007,3,12,8,4,-0.810699999
IND,750.2008,750,India,2008,3,12,8,4,-0.752399981
IND,750.2009,750,India,2009,3,13,8,5,-0.694400012
IND,750.201,750,India,2010,3,13,8,5,-0.733299971
IND,750.2011,750,India,2011,3,13,8,5,-0.784699976
IND,750.2012,750,India,2012,3,13,8,5,-0.785300016
IND,750.2013,750,India,2013,3,12,8,4,-0.735700011
IND,750.2014,750,India,2014,3,12,8,4,-0.799899995
IND,750.2015,750,India,2015,3,12,8,4,-0.76700002
IND,750.2016,750,India,2016,3,11,7,4,NA
IND,750.2017,750,India,2017,3,10,6,4,NA
IND,750.2018,750,India,2018,3,11,7,4,NA
INS,850.1995,850,Indonesia,1995,2,15,9,6,0.055750001
INS,850.1996,850,Indonesia,1996,2,15,9,6,-0.005151
INS,850.1997,850,Indonesia,1997,2,14,8,6,0.103399999
INS,850.1998,850,Indonesia,1998,2,13,9,4,0.226899996
INS,850.1999,850,Indonesia,1999,2,13,9,4,-0.2016
INS,850.2,850,Indonesia,2000,2,13,9,4,-0.106299996
INS,850.2001,850,Indonesia,2001,2,13,9,4,-0.192000002
INS,850.2002,850,Indonesia,2002,2,13,9,4,-0.2148
INS,850.2003,850,Indonesia,2003,2,14,9,5,-0.229599997
INS,850.2004,850,Indonesia,2004,2,11,8,3,-0.532700002
INS,850.2005,850,Indonesia,2005,2,11,8,3,-0.590600014
INS,850.2006,850,Indonesia,2006,2,9,7,2,-0.523100019
INS,850.2007,850,Indonesia,2007,2,10,7,3,-0.622699976
INS,850.2008,850,Indonesia,2008,2,10,7,3,-0.642700016
INS,850.2009,850,Indonesia,2009,2,9,5,4,-0.609700024
INS,850.201,850,Indonesia,2010,2,9,5,4,-0.636200011
INS,850.2011,850,Indonesia,2011,2,9,5,4,-0.593900025
INS,850.2012,850,Indonesia,2012,2,9,5,4,-0.549899995
INS,850.2013,850,Indonesia,2013,2,9,5,4,-0.592000008
INS,850.2014,850,Indonesia,2014,2,8,5,3,-0.649800003
INS,850.2015,850,Indonesia,2015,2,7,4,3,-0.674300015
INS,850.2016,850,Indonesia,2016,2,8,5,3,NA
INS,850.2017,850,Indonesia,2017,2,8,4,4,NA
INS,850.2018,850,Indonesia,2018,2,8,4,4,NA
IRN,630.1995,630,Iran,1995,2,17,8,9,-0.556299984
IRN,630.1996,630,Iran,1996,2,17,8,9,-0.511699975
IRN,630.1997,630,Iran,1997,2,19,8,11,-0.557900012
IRN,630.1998,630,Iran,1998,2,17,8,9,-0.618200004
IRN,630.1999,630,Iran,1999,2,17,6,11,-0.572899997
IRN,630.2,630,Iran,2000,2,16,6,10,-0.552699983
IRN,630.2001,630,Iran,2001,2,16,6,10,-0.445199996
IRN,630.2002,630,Iran,2002,2,16,7,9,-0.27610001
IRN,630.2003,630,Iran,2003,2,16,7,9,-0.263500005
IRN,630.2004,630,Iran,2004,2,15,7,8,-0.202999994
IRN,630.2005,630,Iran,2005,2,15,7,8,-0.4745
IRN,630.2006,630,Iran,2006,2,15,7,8,-0.434199989
IRN,630.2007,630,Iran,2007,2,14,6,8,-0.602100015
IRN,630.2008,630,Iran,2008,2,14,6,8,-0.64349997
IRN,630.2009,630,Iran,2009,2,13,5,8,-0.661599994
IRN,630.201,630,Iran,2010,2,11,3,8,-0.392800003
IRN,630.2011,630,Iran,2011,2,11,3,8,-0.417400002
IRN,630.2012,630,Iran,2012,2,11,3,8,-0.448300004
IRN,630.2013,630,Iran,2013,2,10,3,7,-0.49149999
IRN,630.2014,630,Iran,2014,2,9,2,7,-0.517700016
IRN,630.2015,630,Iran,2015,2,9,2,7,-0.504299998
IRN,630.2016,630,Iran,2016,2,9,2,7,NA
IRN,630.2017,630,Iran,2017,2,9,2,7,NA
IRN,630.2018,630,Iran,2018,2,9,2,7,NA
IRQ,645.1995,645,Iraq,1995,2,19,9,10,0.378199995
IRQ,645.1996,645,Iraq,1996,2,20,10,10,0.381900012
IRQ,645.1997,645,Iraq,1997,2,20,10,10,0.42050001
IRQ,645.1998,645,Iraq,1998,2,20,10,10,0.446500003
IRQ,645.1999,645,Iraq,1999,2,21,10,11,0.447699994
IRQ,645.2,645,Iraq,2000,2,19,9,10,0.433600008
IRQ,645.2001,645,Iraq,2001,2,19,9,10,0.428900003
IRQ,645.2002,645,Iraq,2002,2,19,9,10,0.594200015
IRQ,645.2003,645,Iraq,2003,2,20,11,9,0.701200008
IRQ,645.2004,645,Iraq,2004,2,19,10,9,1.136000037
IRQ,645.2005,645,Iraq,2005,2,21,10,11,0.988600016
IRQ,645.2006,645,Iraq,2006,2,20,10,10,1.213000059
IRQ,645.2007,645,Iraq,2007,2,20,10,10,1.052999973
IRQ,645.2008,645,Iraq,2008,2,20,10,10,0.851400018
IRQ,645.2009,645,Iraq,2009,2,20,10,10,0.935699999
IRQ,645.201,645,Iraq,2010,2,19,9,10,0.792800009
IRQ,645.2011,645,Iraq,2011,2,20,10,10,0.694800019
IRQ,645.2012,645,Iraq,2012,2,19,9,10,0.628799975
IRQ,645.2013,645,Iraq,2013,2,18,8,10,0.723100007
IRQ,645.2014,645,Iraq,2014,2,18,8,10,0.736100018
IRQ,645.2015,645,Iraq,2015,2,18,8,10,0.632700026
IRQ,645.2016,645,Iraq,2016,2,18,8,10,NA
IRQ,645.2017,645,Iraq,2017,2,18,8,10,NA
IRQ,645.2018,645,Iraq,2018,2,18,8,10,NA
ISR,666.1995,666,Israel,1995,99,7,3,4,-1.927999973
ISR,666.1996,666,Israel,1996,99,7,3,4,-1.919999957
ISR,666.1997,666,Israel,1997,99,7,3,4,-1.940000057
ISR,666.1998,666,Israel,1998,99,7,3,4,-1.929999948
ISR,666.1999,666,Israel,1999,99,8,3,5,-1.906999946
ISR,666.2,666,Israel,2000,99,8,3,5,-1.952999949
ISR,666.2001,666,Israel,2001,99,8,3,5,-1.942999959
ISR,666.2002,666,Israel,2002,99,9,3,6,-1.906000018
ISR,666.2003,666,Israel,2003,99,9,3,6,-1.881999969
ISR,666.2004,666,Israel,2004,99,9,3,6,-1.878999949
ISR,666.2005,666,Israel,2005,99,8,3,5,-1.899000049
ISR,666.2006,666,Israel,2006,99,8,3,5,-1.93599999
ISR,666.2007,666,Israel,2007,99,8,3,5,-1.94599998
ISR,666.2008,666,Israel,2008,99,9,3,6,-1.91900003
ISR,666.2009,666,Israel,2009,99,9,3,6,-1.85800004
ISR,666.201,666,Israel,2010,99,8,2,6,-1.809000015
ISR,666.2011,666,Israel,2011,99,8,2,6,-1.833999991
ISR,666.2012,666,Israel,2012,99,8,2,6,-1.817000031
ISR,666.2013,666,Israel,2013,99,8,2,6,-1.75999999
ISR,666.2014,666,Israel,2014,99,7,2,5,-1.776000023
ISR,666.2015,666,Israel,2015,99,7,2,5,-1.754999995
ISR,666.2016,666,Israel,2016,99,7,2,5,NA
ISR,666.2017,666,Israel,2017,99,7,2,5,NA
ISR,666.2018,666,Israel,2018,99,7,2,5,NA
IVO,437.1995,437,Cote d'Ivoire,1995,1,16,8,8,0.02812
IVO,437.1996,437,Cote d'Ivoire,1996,1,16,8,8,-0.01445
IVO,437.1997,437,Cote d'Ivoire,1997,1,15,8,7,-0.01479
IVO,437.1998,437,Cote d'Ivoire,1998,1,15,8,7,-0.009919
IVO,437.1999,437,Cote d'Ivoire,1999,1,16,9,7,-0.005265
IVO,437.2,437,Cote d'Ivoire,2000,1,19,10,9,0.065260001
IVO,437.2001,437,Cote d'Ivoire,2001,1,19,10,9,0.227300003
IVO,437.2002,437,Cote d'Ivoire,2002,1,20,10,10,0.430000007
IVO,437.2003,437,Cote d'Ivoire,2003,1,20,10,10,0.523699999
IVO,437.2004,437,Cote d'Ivoire,2004,1,21,10,11,0.171900004
IVO,437.2005,437,Cote d'Ivoire,2005,1,18,9,9,0.197899997
IVO,437.2006,437,Cote d'Ivoire,2006,1,18,9,9,0.428200006
IVO,437.2007,437,Cote d'Ivoire,2007,1,15,9,6,0.476599991
IVO,437.2008,437,Cote d'Ivoire,2008,1,15,9,6,0.557600021
IVO,437.2009,437,Cote d'Ivoire,2009,1,15,9,6,0.500100017
IVO,437.201,437,Cote d'Ivoire,2010,1,18,9,9,0.574000001
IVO,437.2011,437,Cote d'Ivoire,2011,1,16,9,7,0.444999993
IVO,437.2012,437,Cote d'Ivoire,2012,1,16,9,7,0.394199997
IVO,437.2013,437,Cote d'Ivoire,2013,1,16,9,7,0.289799988
IVO,437.2014,437,Cote d'Ivoire,2014,1,17,9,8,0.282299995
IVO,437.2015,437,Cote d'Ivoire,2015,1,17,9,8,0.071359999
IVO,437.2016,437,Cote d'Ivoire,2016,1,17,9,8,NA
IVO,437.2017,437,Cote d'Ivoire,2017,1,17,8,9,NA
IVO,437.2018,437,Cote d'Ivoire,2018,1,16,7,9,NA
JOR,663.1995,663,Jordan,1995,2,9,5,4,-0.288399994
JOR,663.1996,663,Jordan,1996,2,9,5,4,-0.303200006
JOR,663.1997,663,Jordan,1997,2,9,5,4,-0.182699993
JOR,663.1998,663,Jordan,1998,2,9,5,4,-0.145099998
JOR,663.1999,663,Jordan,1999,2,7,3,4,-0.174400002
JOR,663.2,663,Jordan,2000,2,7,3,4,-0.198599994
JOR,663.2001,663,Jordan,2001,2,7,3,4,-0.239800006
JOR,663.2002,663,Jordan,2002,2,6,3,3,-0.224299997
JOR,663.2003,663,Jordan,2003,2,6,3,3,-0.247199997
JOR,663.2004,663,Jordan,2004,2,6,3,3,-0.274500012
JOR,663.2005,663,Jordan,2005,2,6,3,3,-0.341600001
JOR,663.2006,663,Jordan,2006,2,6,3,3,-0.368099988
JOR,663.2007,663,Jordan,2007,2,6,3,3,-0.402500004
JOR,663.2008,663,Jordan,2008,2,6,3,3,-0.389800012
JOR,663.2009,663,Jordan,2009,2,6,3,3,-0.436699986
JOR,663.201,663,Jordan,2010,2,6,3,3,-0.476300001
JOR,663.2011,663,Jordan,2011,2,7,3,4,-0.430500001
JOR,663.2012,663,Jordan,2012,2,8,4,4,-0.434199989
JOR,663.2013,663,Jordan,2013,2,7,3,4,-0.434500009
JOR,663.2014,663,Jordan,2014,2,6,3,3,-0.437900007
JOR,663.2015,663,Jordan,2015,2,6,3,3,-0.455799997
JOR,663.2016,663,Jordan,2016,2,6,3,3,NA
JOR,663.2017,663,Jordan,2017,2,7,3,4,NA
JOR,663.2018,663,Jordan,2018,2,7,3,4,NA
KEN,501.1995,501,Kenya,1995,1,15,8,7,-0.096019998
KEN,501.1996,501,Kenya,1996,1,14,7,7,-0.081299998
KEN,501.1997,501,Kenya,1997,1,15,7,8,-0.041030001
KEN,501.1998,501,Kenya,1998,1,15,7,8,0.207100004
KEN,501.1999,501,Kenya,1999,1,15,7,8,0.272199988
KEN,501.2,501,Kenya,2000,1,16,8,8,0.258700013
KEN,501.2001,501,Kenya,2001,1,16,8,8,0.2588
KEN,501.2002,501,Kenya,2002,1,17,9,8,0.169
KEN,501.2003,501,Kenya,2003,1,14,8,6,0.076339997
KEN,501.2004,501,Kenya,2004,1,13,7,6,0.054839998
KEN,501.2005,501,Kenya,2005,1,12,6,6,0.0008651
KEN,501.2006,501,Kenya,2006,1,12,7,5,0.01932
KEN,501.2007,501,Kenya,2007,1,14,7,7,0.0000431
KEN,501.2008,501,Kenya,2008,1,14,7,7,-0.028729999
KEN,501.2009,501,Kenya,2009,1,14,7,7,-0.02612
KEN,501.201,501,Kenya,2010,1,12,7,5,-0.1021
KEN,501.2011,501,Kenya,2011,1,12,7,5,-0.119800001
KEN,501.2012,501,Kenya,2012,1,10,6,4,-0.117399998
KEN,501.2013,501,Kenya,2013,1,10,6,4,0.069789998
KEN,501.2014,501,Kenya,2014,1,10,6,4,0.05164
KEN,501.2015,501,Kenya,2015,1,10,6,4,0.07886
KEN,501.2016,501,Kenya,2016,1,10,5,5,NA
KEN,501.2017,501,Kenya,2017,1,10,5,5,NA
KEN,501.2018,501,Kenya,2018,1,10,5,5,NA
KYR,703.1995,703,Kyrgyzstan,1995,2,10,7,3,0.316100001
KYR,703.1996,703,Kyrgyzstan,1996,2,11,7,4,0.476200014
KYR,703.1997,703,Kyrgyzstan,1997,2,11,7,4,0.485500008
KYR,703.1998,703,Kyrgyzstan,1998,2,10,7,3,0.484100014
KYR,703.1999,703,Kyrgyzstan,1999,2,12,7,5,0.504499972
KYR,703.2,703,Kyrgyzstan,2000,2,12,7,5,0.465299994
KYR,703.2001,703,Kyrgyzstan,2001,2,10,6,4,0.542100012
KYR,703.2002,703,Kyrgyzstan,2002,2,11,6,5,0.505599976
KYR,703.2003,703,Kyrgyzstan,2003,2,11,7,4,0.4815
KYR,703.2004,703,Kyrgyzstan,2004,2,12,8,4,-0.051029999
KYR,703.2005,703,Kyrgyzstan,2005,2,12,8,4,0.04772
KYR,703.2006,703,Kyrgyzstan,2006,2,12,8,4,0.060079999
KYR,703.2007,703,Kyrgyzstan,2007,2,10,6,4,-0.044780001
KYR,703.2008,703,Kyrgyzstan,2008,2,10,6,4,-0.160500005
KYR,703.2009,703,Kyrgyzstan,2009,2,10,6,4,-0.214900002
KYR,703.201,703,Kyrgyzstan,2010,2,13,8,5,-0.222900003
KYR,703.2011,703,Kyrgyzstan,2011,2,13,8,5,-0.171000004
KYR,703.2012,703,Kyrgyzstan,2012,2,12,7,5,-0.141000003
KYR,703.2013,703,Kyrgyzstan,2013,2,12,7,5,-0.215399995
KYR,703.2014,703,Kyrgyzstan,2014,2,12,7,5,-0.267100006
KYR,703.2015,703,Kyrgyzstan,2015,2,12,7,5,-0.223900005
KYR,703.2016,703,Kyrgyzstan,2016,2,12,7,5,NA
KYR,703.2017,703,Kyrgyzstan,2017,2,12,7,5,NA
KYR,703.2018,703,Kyrgyzstan,2018,2,12,7,5,NA
KZK,705.1995,705,Kazakhstan,1995,2,10,4,6,-0.01023
KZK,705.1996,705,Kazakhstan,1996,2,10,4,6,-0.124499999
KZK,705.1997,705,Kazakhstan,1997,2,9,4,5,-0.167999998
KZK,705.1998,705,Kazakhstan,1998,2,11,4,7,-0.131799996
KZK,705.1999,705,Kazakhstan,1999,2,11,4,7,-0.278699994
KZK,705.2,705,Kazakhstan,2000,2,11,4,7,-0.345499992
KZK,705.2001,705,Kazakhstan,2001,2,10,3,7,-0.39199999
KZK,705.2002,705,Kazakhstan,2002,2,9,3,6,-0.395799994
KZK,705.2003,705,Kazakhstan,2003,2,8,2,6,-0.432099998
KZK,705.2004,705,Kazakhstan,2004,2,9,3,6,-0.691399992
KZK,705.2005,705,Kazakhstan,2005,2,9,3,6,-0.860300004
KZK,705.2006,705,Kazakhstan,2006,2,9,3,6,-0.857599974
KZK,705.2007,705,Kazakhstan,2007,2,9,3,6,-0.905900002
KZK,705.2008,705,Kazakhstan,2008,2,9,3,6,-0.855199993
KZK,705.2009,705,Kazakhstan,2009,2,9,3,6,-0.825699985
KZK,705.201,705,Kazakhstan,2010,2,9,3,6,-0.819199979
KZK,705.2011,705,Kazakhstan,2011,2,9,3,6,-0.709900022
KZK,705.2012,705,Kazakhstan,2012,2,9,3,6,-0.856400013
KZK,705.2013,705,Kazakhstan,2013,2,9,3,6,-0.879700005
KZK,705.2014,705,Kazakhstan,2014,2,9,3,6,-0.791400015
KZK,705.2015,705,Kazakhstan,2015,2,9,3,6,-0.81129998
KZK,705.2016,705,Kazakhstan,2016,2,9,3,6,NA
KZK,705.2017,705,Kazakhstan,2017,2,9,3,6,NA
KZK,705.2018,705,Kazakhstan,2018,2,9,3,6,NA
LEB,660.1995,660,Lebanon,1995,2,12,6,6,0.497700006
LEB,660.1996,660,Lebanon,1996,2,12,6,6,0.433099985
LEB,660.1997,660,Lebanon,1997,2,12,6,6,0.444599986
LEB,660.1998,660,Lebanon,1998,2,12,6,6,0.404199988
LEB,660.1999,660,Lebanon,1999,2,12,6,6,0.232299998
LEB,660.2,660,Lebanon,2000,2,12,6,6,0.209099993
LEB,660.2001,660,Lebanon,2001,2,12,6,6,0.109899998
LEB,660.2002,660,Lebanon,2002,2,11,6,5,0.021400001
LEB,660.2003,660,Lebanon,2003,2,11,6,5,-0.02452
LEB,660.2004,660,Lebanon,2004,2,11,5,6,0.27790001
LEB,660.2005,660,Lebanon,2005,2,12,5,7,0.176300004
LEB,660.2006,660,Lebanon,2006,2,10,5,5,0.276899993
LEB,660.2007,660,Lebanon,2007,2,10,4,6,0.254799992
LEB,660.2008,660,Lebanon,2008,2,9,4,5,0.144999996
LEB,660.2009,660,Lebanon,2009,2,8,4,4,0.1197
LEB,660.201,660,Lebanon,2010,2,7,3,4,0.075170003
LEB,660.2011,660,Lebanon,2011,2,7,3,4,0.001817
LEB,660.2012,660,Lebanon,2012,2,6,2,4,0.002995
LEB,660.2013,660,Lebanon,2013,2,6,2,4,0.01842
LEB,660.2014,660,Lebanon,2014,2,6,2,4,0.084600002
LEB,660.2015,660,Lebanon,2015,2,5,1,4,-0.02478
LEB,660.2016,660,Lebanon,2016,2,5,1,4,NA
LEB,660.2017,660,Lebanon,2017,2,5,1,4,NA
LEB,660.2018,660,Lebanon,2018,2,5,1,4,NA
LES,570.1995,570,Lesotho,1995,1,13,8,5,0.080849998
LES,570.1996,570,Lesotho,1996,1,12,8,4,0.134000003
LES,570.1997,570,Lesotho,1997,1,13,8,5,0.09426
LES,570.1998,570,Lesotho,1998,1,15,8,7,0.031199999
LES,570.1999,570,Lesotho,1999,1,11,8,3,-0.03084
LES,570.2,570,Lesotho,2000,1,11,8,3,-0.07265
LES,570.2001,570,Lesotho,2001,1,11,8,3,-0.115199998
LES,570.2002,570,Lesotho,2002,1,14,9,5,-0.064470001
LES,570.2003,570,Lesotho,2003,1,14,9,5,-0.199900001
LES,570.2004,570,Lesotho,2004,1,13,9,4,-0.262199998
LES,570.2005,570,Lesotho,2005,1,13,8,5,-0.210600004
LES,570.2006,570,Lesotho,2006,1,11,7,4,-0.257400006
LES,570.2007,570,Lesotho,2007,1,13,8,5,-0.112400003
LES,570.2008,570,Lesotho,2008,1,12,8,4,-0.031410001
LES,570.2009,570,Lesotho,2009,1,11,8,3,-0.096249998
LES,570.201,570,Lesotho,2010,1,11,8,3,-0.068049997
LES,570.2011,570,Lesotho,2011,1,11,8,3,-0.084459998
LES,570.2012,570,Lesotho,2012,1,8,6,2,-0.172999993
LES,570.2013,570,Lesotho,2013,1,8,6,2,-0.188899994
LES,570.2014,570,Lesotho,2014,1,9,7,2,-0.215200007
LES,570.2015,570,Lesotho,2015,1,9,7,2,-0.080530003
LES,570.2016,570,Lesotho,2016,1,9,7,2,NA
LES,570.2017,570,Lesotho,2017,1,10,7,3,NA
LES,570.2018,570,Lesotho,2018,1,10,7,3,NA
LIB,620.1995,620,Libya,1995,2,9,4,5,0.002652
LIB,620.1996,620,Libya,1996,2,9,4,5,0.128600001
LIB,620.1997,620,Libya,1997,2,10,4,6,0.298099995
LIB,620.1998,620,Libya,1998,2,11,4,7,0.241899997
LIB,620.1999,620,Libya,1999,2,11,4,7,0.416900009
LIB,620.2,620,Libya,2000,2,10,4,6,0.504100025
LIB,620.2001,620,Libya,2001,2,10,4,6,0.514299989
LIB,620.2002,620,Libya,2002,2,10,4,6,0.172900006
LIB,620.2003,620,Libya,2003,2,10,4,6,0.503300011
LIB,620.2004,620,Libya,2004,2,10,4,6,0.713
LIB,620.2005,620,Libya,2005,2,8,2,6,0.561800003
LIB,620.2006,620,Libya,2006,2,8,2,6,0.331200004
LIB,620.2007,620,Libya,2007,2,8,2,6,0.204300001
LIB,620.2008,620,Libya,2008,2,7,1,6,0.091480002
LIB,620.2009,620,Libya,2009,2,7,1,6,0.102899998
LIB,620.201,620,Libya,2010,2,7,1,6,0.182999998
LIB,620.2011,620,Libya,2011,2,15,5,10,0.633700013
LIB,620.2012,620,Libya,2012,2,14,5,9,0.533200026
LIB,620.2013,620,Libya,2013,2,13,5,8,0.661199987
LIB,620.2014,620,Libya,2014,2,13,5,8,0.889800012
LIB,620.2015,620,Libya,2015,2,13,5,8,1.351999998
LIB,620.2016,620,Libya,2016,2,13,5,8,NA
LIB,620.2017,620,Libya,2017,2,14,5,9,NA
LIB,620.2018,620,Libya,2018,2,14,5,9,NA
MAA,435.1995,435,Mauritania,1995,2,18,9,9,0.129999995
MAA,435.1996,435,Mauritania,1996,2,17,9,8,0.104500003
MAA,435.1997,435,Mauritania,1997,2,19,10,9,0.031490002
MAA,435.1998,435,Mauritania,1998,2,15,10,5,0.079000004
MAA,435.1999,435,Mauritania,1999,2,15,10,5,0.049849998
MAA,435.2,435,Mauritania,2000,2,17,9,8,-0.002712
MAA,435.2001,435,Mauritania,2001,2,18,9,9,-0.003158
MAA,435.2002,435,Mauritania,2002,2,17,8,9,-0.059640002
MAA,435.2003,435,Mauritania,2003,2,17,9,8,-0.003524
MAA,435.2004,435,Mauritania,2004,2,17,9,8,0.217899993
MAA,435.2005,435,Mauritania,2005,2,16,8,8,0.094169997
MAA,435.2006,435,Mauritania,2006,2,16,8,8,0.031750001
MAA,435.2007,435,Mauritania,2007,2,16,8,8,0.109700002
MAA,435.2008,435,Mauritania,2008,2,16,8,8,-0.070929997
MAA,435.2009,435,Mauritania,2009,2,16,8,8,-0.006014
MAA,435.201,435,Mauritania,2010,2,16,8,8,0.114
MAA,435.2011,435,Mauritania,2011,2,16,8,8,0.059429999
MAA,435.2012,435,Mauritania,2012,2,16,8,8,0.086199999
MAA,435.2013,435,Mauritania,2013,2,16,8,8,0.324900001
MAA,435.2014,435,Mauritania,2014,2,16,8,8,0.290300012
MAA,435.2015,435,Mauritania,2015,2,16,8,8,0.164199993
MAA,435.2016,435,Mauritania,2016,2,16,8,8,NA
MAA,435.2017,435,Mauritania,2017,2,16,8,8,NA
MAA,435.2018,435,Mauritania,2018,2,16,8,8,NA
MAG,580.1995,580,Madagascar,1995,1,17,10,7,0.916499972
MAG,580.1996,580,Madagascar,1996,1,17,10,7,0.850899994
MAG,580.1997,580,Madagascar,1997,1,16,10,6,0.902400017
MAG,580.1998,580,Madagascar,1998,1,14,10,4,0.950200021
MAG,580.1999,580,Madagascar,1999,1,13,10,3,0.918299973
MAG,580.2,580,Madagascar,2000,1,13,10,3,0.763199985
MAG,580.2001,580,Madagascar,2001,1,13,10,3,0.780499995
MAG,580.2002,580,Madagascar,2002,1,15,10,5,0.711000025
MAG,580.2003,580,Madagascar,2003,1,15,10,5,0.665000021
MAG,580.2004,580,Madagascar,2004,1,13,9,4,0.551400006
MAG,580.2005,580,Madagascar,2005,1,12,8,4,0.533299983
MAG,580.2006,580,Madagascar,2006,1,12,9,3,0.299499989
MAG,580.2007,580,Madagascar,2007,1,10,8,2,0.269199997
MAG,580.2008,580,Madagascar,2008,1,10,8,2,0.157900006
MAG,580.2009,580,Madagascar,2009,1,14,9,5,0.379099995
MAG,580.201,580,Madagascar,2010,1,14,9,5,0.478799999
MAG,580.2011,580,Madagascar,2011,1,12,9,3,0.629299998
MAG,580.2012,580,Madagascar,2012,1,12,9,3,0.719600022
MAG,580.2013,580,Madagascar,2013,1,12,9,3,0.764100015
MAG,580.2014,580,Madagascar,2014,1,12,9,3,0.778400004
MAG,580.2015,580,Madagascar,2015,1,11,8,3,0.638100028
MAG,580.2016,580,Madagascar,2016,1,11,8,3,NA
MAG,580.2017,580,Madagascar,2017,1,12,9,3,NA
MAG,580.2018,580,Madagascar,2018,1,12,9,3,NA
MAL,820.1995,820,Malaysia,1995,2,8,4,4,-0.70539999
MAL,820.1996,820,Malaysia,1996,2,8,4,4,-0.7403
MAL,820.1997,820,Malaysia,1997,2,8,4,4,-0.746599972
MAL,820.1998,820,Malaysia,1998,2,9,4,5,-0.729499996
MAL,820.1999,820,Malaysia,1999,2,9,4,5,-0.52700001
MAL,820.2,820,Malaysia,2000,2,8,3,5,-0.4278
MAL,820.2001,820,Malaysia,2001,2,7,2,5,-0.537199974
MAL,820.2002,820,Malaysia,2002,2,7,3,4,-0.55339998
MAL,820.2003,820,Malaysia,2003,2,6,2,4,-0.521399975
MAL,820.2004,820,Malaysia,2004,2,5,1,4,-0.599600017
MAL,820.2005,820,Malaysia,2005,2,5,1,4,-0.739000022
MAL,820.2006,820,Malaysia,2006,2,5,1,4,-0.850300014
MAL,820.2007,820,Malaysia,2007,2,5,1,4,-0.867399991
MAL,820.2008,820,Malaysia,2008,2,6,2,4,-0.883300006
MAL,820.2009,820,Malaysia,2009,2,6,2,4,-0.969699979
MAL,820.201,820,Malaysia,2010,2,6,2,4,-0.89139998
MAL,820.2011,820,Malaysia,2011,2,6,2,4,-0.888199985
MAL,820.2012,820,Malaysia,2012,2,6,2,4,-0.805899978
MAL,820.2013,820,Malaysia,2013,2,6,2,4,-0.85680002
MAL,820.2014,820,Malaysia,2014,2,6,2,4,-0.882799983
MAL,820.2015,820,Malaysia,2015,2,5,1,4,-0.811699986
MAL,820.2016,820,Malaysia,2016,2,5,1,4,NA
MAL,820.2017,820,Malaysia,2017,2,5,1,4,NA
MAL,820.2018,820,Malaysia,2018,2,3,0,3,NA
MLI,432.1995,432,Mali,1995,2,21,11,10,0.55430001
MLI,432.1996,432,Mali,1996,2,18,11,7,0.534200013
MLI,432.1997,432,Mali,1997,2,19,11,8,0.558899999
MLI,432.1998,432,Mali,1998,2,19,11,8,0.555800021
MLI,432.1999,432,Mali,1999,2,18,11,7,0.5176
MLI,432.2,432,Mali,2000,2,17,10,7,0.5449
MLI,432.2001,432,Mali,2001,2,17,10,7,0.534399986
MLI,432.2002,432,Mali,2002,2,17,9,8,0.535000026
MLI,432.2003,432,Mali,2003,2,16,9,7,0.466600001
MLI,432.2004,432,Mali,2004,2,16,9,7,0.497200012
MLI,432.2005,432,Mali,2005,2,17,9,8,0.145799994
MLI,432.2006,432,Mali,2006,2,15,8,7,0.054790001
MLI,432.2007,432,Mali,2007,2,15,8,7,0.099490002
MLI,432.2008,432,Mali,2008,2,15,8,7,0.194299996
MLI,432.2009,432,Mali,2009,2,15,8,7,0.1787
MLI,432.201,432,Mali,2010,2,14,8,6,0.175699994
MLI,432.2011,432,Mali,2011,2,14,8,6,0.176699996
MLI,432.2012,432,Mali,2012,2,21,11,10,0.073509999
MLI,432.2013,432,Mali,2013,2,17,9,8,0.177100003
MLI,432.2014,432,Mali,2014,2,17,9,8,0.201199993
MLI,432.2015,432,Mali,2015,2,16,8,8,0.165000007
MLI,432.2016,432,Mali,2016,2,16,8,8,NA
MLI,432.2017,432,Mali,2017,2,15,7,8,NA
MLI,432.2018,432,Mali,2018,2,15,7,8,NA
MYA,775.1995,775,Myanmar,1995,3,19,8,11,0.353100002
MYA,775.1996,775,Myanmar,1996,3,18,8,10,0.500500023
MYA,775.1997,775,Myanmar,1997,3,18,8,10,0.569999993
MYA,775.1998,775,Myanmar,1998,3,19,8,11,0.479499996
MYA,775.1999,775,Myanmar,1999,3,19,8,11,0.515699983
MYA,775.2,775,Myanmar,2000,3,19,8,11,0.393400013
MYA,775.2001,775,Myanmar,2001,3,19,8,11,0.451000005
MYA,775.2002,775,Myanmar,2002,3,19,9,10,0.392399997
MYA,775.2003,775,Myanmar,2003,3,18,8,10,0.244299993
MYA,775.2004,775,Myanmar,2004,3,18,8,10,0.28459999
MYA,775.2005,775,Myanmar,2005,3,19,9,10,0.242200002
MYA,775.2006,775,Myanmar,2006,3,20,9,11,0.569199979
MYA,775.2007,775,Myanmar,2007,3,20,9,11,0.593699992
MYA,775.2008,775,Myanmar,2008,3,20,9,11,0.708899975
MYA,775.2009,775,Myanmar,2009,3,19,9,10,0.887600005
MYA,775.201,775,Myanmar,2010,3,20,9,11,0.666199982
MYA,775.2011,775,Myanmar,2011,3,20,9,11,0.547200024
MYA,775.2012,775,Myanmar,2012,3,20,9,11,0.67839998
MYA,775.2013,775,Myanmar,2013,3,19,8,11,0.507499993
MYA,775.2014,775,Myanmar,2014,3,18,8,10,0.431300014
MYA,775.2015,775,Myanmar,2015,3,18,8,10,0.302599996
MYA,775.2016,775,Myanmar,2016,3,19,9,10,NA
MYA,775.2017,775,Myanmar,2017,3,18,9,9,NA
MYA,775.2018,775,Myanmar,2018,3,18,8,10,NA
NAM,565.1995,565,Namibia,1995,1,6,5,1,-1.006999969
NAM,565.1996,565,Namibia,1996,1,7,5,2,-1.014999986
NAM,565.1997,565,Namibia,1997,1,7,5,2,-1.034000039
NAM,565.1998,565,Namibia,1998,1,9,5,4,-0.994000018
NAM,565.1999,565,Namibia,1999,1,9,5,4,-0.999199986
NAM,565.2,565,Namibia,2000,1,7,3,4,-0.923399985
NAM,565.2001,565,Namibia,2001,1,8,4,4,-0.930999994
NAM,565.2002,565,Namibia,2002,1,7,3,4,-0.962100029
NAM,565.2003,565,Namibia,2003,1,8,4,4,-0.98360002
NAM,565.2004,565,Namibia,2004,1,8,4,4,-0.612999976
NAM,565.2005,565,Namibia,2005,1,7,3,4,-0.634299994
NAM,565.2006,565,Namibia,2006,1,7,3,4,-0.610700011
NAM,565.2007,565,Namibia,2007,1,6,3,3,-0.655700028
NAM,565.2008,565,Namibia,2008,1,6,3,3,-0.649999976
NAM,565.2009,565,Namibia,2009,1,5,2,3,-0.589999974
NAM,565.201,565,Namibia,2010,1,5,2,3,-0.686699986
NAM,565.2011,565,Namibia,2011,1,5,2,3,-0.783599973
NAM,565.2012,565,Namibia,2012,1,5,2,3,-0.693700016
NAM,565.2013,565,Namibia,2013,1,5,2,3,-0.678600013
NAM,565.2014,565,Namibia,2014,1,5,2,3,-0.617900014
NAM,565.2015,565,Namibia,2015,1,5,2,3,-0.655099988
NAM,565.2016,565,Namibia,2016,1,5,2,3,NA
NAM,565.2017,565,Namibia,2017,1,5,2,3,NA
NAM,565.2018,565,Namibia,2018,1,5,2,3,NA
NIC,93.1995,93,Nicaragua,1995,4,15,8,7,0.200800002
NIC,93.1996,93,Nicaragua,1996,4,14,8,6,0.203400001
NIC,93.1997,93,Nicaragua,1997,4,15,8,7,0.189899996
NIC,93.1998,93,Nicaragua,1998,4,16,8,8,0.195299998
NIC,93.1999,93,Nicaragua,1999,4,15,8,7,0.199900001
NIC,93.2,93,Nicaragua,2000,4,13,6,7,0.214399993
NIC,93.2001,93,Nicaragua,2001,4,12,6,6,0.215000004
NIC,93.2002,93,Nicaragua,2002,4,12,6,6,0.186299995
NIC,93.2003,93,Nicaragua,2003,4,12,6,6,0.144800007
NIC,93.2004,93,Nicaragua,2004,4,12,6,6,-0.089189999
NIC,93.2005,93,Nicaragua,2005,4,10,4,6,-0.238100007
NIC,93.2006,93,Nicaragua,2006,4,12,5,7,-0.156499997
NIC,93.2007,93,Nicaragua,2007,4,9,4,5,-0.169
NIC,93.2008,93,Nicaragua,2008,4,9,4,5,-0.062240001
NIC,93.2009,93,Nicaragua,2009,4,10,4,6,-0.110299997
NIC,93.201,93,Nicaragua,2010,4,10,4,6,-0.152700007
NIC,93.2011,93,Nicaragua,2011,4,10,4,6,-0.069880001
NIC,93.2012,93,Nicaragua,2012,4,9,4,5,-0.067649998
NIC,93.2013,93,Nicaragua,2013,4,8,3,5,-0.082649998
NIC,93.2014,93,Nicaragua,2014,4,7,3,4,-0.060740001
NIC,93.2015,93,Nicaragua,2015,4,8,4,4,-0.135199994
NIC,93.2016,93,Nicaragua,2016,4,8,5,3,NA
NIC,93.2017,93,Nicaragua,2017,4,7,5,2,NA
NIC,93.2018,93,Nicaragua,2018,4,7,5,2,NA
NIG,475.1995,475,Nigeria,1995,1,21,10,11,0.672999978
NIG,475.1996,475,Nigeria,1996,1,20,10,10,0.756200016
NIG,475.1997,475,Nigeria,1997,1,20,10,10,0.606999993
NIG,475.1998,475,Nigeria,1998,1,21,11,10,0.573599994
NIG,475.1999,475,Nigeria,1999,1,20,11,9,0.532599986
NIG,475.2,475,Nigeria,2000,1,20,11,9,0.548600018
NIG,475.2001,475,Nigeria,2001,1,20,11,9,0.614600003
NIG,475.2002,475,Nigeria,2002,1,20,11,9,0.675599992
NIG,475.2003,475,Nigeria,2003,1,20,11,9,0.671000004
NIG,475.2004,475,Nigeria,2004,1,20,11,9,0.808000028
NIG,475.2005,475,Nigeria,2005,1,20,11,9,0.722100019
NIG,475.2006,475,Nigeria,2006,1,20,11,9,0.690999985
NIG,475.2007,475,Nigeria,2007,1,19,10,9,0.514599979
NIG,475.2008,475,Nigeria,2008,1,19,10,9,0.404100001
NIG,475.2009,475,Nigeria,2009,1,18,9,9,0.394800007
NIG,475.201,475,Nigeria,2010,1,17,8,9,0.228100002
NIG,475.2011,475,Nigeria,2011,1,17,8,9,0.224299997
NIG,475.2012,475,Nigeria,2012,1,16,8,8,0.260100007
NIG,475.2013,475,Nigeria,2013,1,17,8,9,0.269899994
NIG,475.2014,475,Nigeria,2014,1,17,8,9,0.398400009
NIG,475.2015,475,Nigeria,2015,1,18,9,9,0.389999986
NIG,475.2016,475,Nigeria,2016,1,18,9,9,NA
NIG,475.2017,475,Nigeria,2017,1,18,9,9,NA
NIG,475.2018,475,Nigeria,2018,1,18,9,9,NA
NIR,436.1995,436,Niger,1995,2,20,10,10,0.681400001
NIR,436.1996,436,Niger,1996,2,18,10,8,0.752900004
NIR,436.1997,436,Niger,1997,2,18,10,8,0.825800002
NIR,436.1998,436,Niger,1998,2,18,10,8,0.809800029
NIR,436.1999,436,Niger,1999,2,18,10,8,0.744899988
NIR,436.2,436,Niger,2000,2,18,10,8,0.761699975
NIR,436.2001,436,Niger,2001,2,18,10,8,0.679199994
NIR,436.2002,436,Niger,2002,2,18,10,8,0.718500018
NIR,436.2003,436,Niger,2003,2,18,10,8,0.675499976
NIR,436.2004,436,Niger,2004,2,17,9,8,0.334600002
NIR,436.2005,436,Niger,2005,2,17,9,8,0.254099995
NIR,436.2006,436,Niger,2006,2,17,9,8,0.313300014
NIR,436.2007,436,Niger,2007,2,18,9,9,0.277099997
NIR,436.2008,436,Niger,2008,2,18,9,9,0.314700007
NIR,436.2009,436,Niger,2009,2,17,9,8,0.223100007
NIR,436.201,436,Niger,2010,2,18,10,8,0.171900004
NIR,436.2011,436,Niger,2011,2,18,10,8,0.1193
NIR,436.2012,436,Niger,2012,2,18,10,8,0.059149999
NIR,436.2013,436,Niger,2013,2,18,10,8,0.018750001
NIR,436.2014,436,Niger,2014,2,18,10,8,0.039179999
NIR,436.2015,436,Niger,2015,2,18,10,8,-0.048149999
NIR,436.2016,436,Niger,2016,2,18,10,8,NA
NIR,436.2017,436,Niger,2017,2,18,10,8,NA
NIR,436.2018,436,Niger,2018,2,19,10,9,NA
PAK,770.1995,770,Pakistan,1995,2,18,10,8,0.251300007
PAK,770.1996,770,Pakistan,1996,2,18,10,8,0.067890003
PAK,770.1997,770,Pakistan,1997,2,17,9,8,0.01612
PAK,770.1998,770,Pakistan,1998,2,16,8,8,0.085689999
PAK,770.1999,770,Pakistan,1999,2,16,9,7,0.05229
PAK,770.2,770,Pakistan,2000,2,17,10,7,0.041450001
PAK,770.2001,770,Pakistan,2001,2,17,10,7,0.04417
PAK,770.2002,770,Pakistan,2002,2,17,10,7,-0.001801
PAK,770.2003,770,Pakistan,2003,2,16,9,7,-0.006507
PAK,770.2004,770,Pakistan,2004,2,15,9,6,-0.1241
PAK,770.2005,770,Pakistan,2005,2,16,10,6,-0.240099996
PAK,770.2006,770,Pakistan,2006,2,15,9,6,-0.159600005
PAK,770.2007,770,Pakistan,2007,2,16,9,7,-0.263500005
PAK,770.2008,770,Pakistan,2008,2,16,9,7,-0.200399995
PAK,770.2009,770,Pakistan,2009,2,16,9,7,-0.179399997
PAK,770.201,770,Pakistan,2010,2,15,8,7,-0.097400002
PAK,770.2011,770,Pakistan,2011,2,16,8,8,-0.061730001
PAK,770.2012,770,Pakistan,2012,2,16,8,8,0.009725
PAK,770.2013,770,Pakistan,2013,2,16,8,8,0.03661
PAK,770.2014,770,Pakistan,2014,2,16,8,8,-0.02936
PAK,770.2015,770,Pakistan,2015,2,16,8,8,-0.01237
PAK,770.2016,770,Pakistan,2016,2,16,8,8,NA
PAK,770.2017,770,Pakistan,2017,2,16,8,8,NA
PAK,770.2018,770,Pakistan,2018,2,15,7,8,NA
PAR,150.1995,150,Paraguay,1995,4,10,5,5,-0.243599996
PAR,150.1996,150,Paraguay,1996,4,10,5,5,-0.256399989
PAR,150.1997,150,Paraguay,1997,4,10,5,5,-0.222200006
PAR,150.1998,150,Paraguay,1998,4,10,5,5,-0.185100004
PAR,150.1999,150,Paraguay,1999,4,10,5,5,-0.079510003
PAR,150.2,150,Paraguay,2000,4,11,6,5,-0.026559999
PAR,150.2001,150,Paraguay,2001,4,11,6,5,-0.007176
PAR,150.2002,150,Paraguay,2002,4,10,5,5,0.093120001
PAR,150.2003,150,Paraguay,2003,4,10,5,5,0.145199999
PAR,150.2004,150,Paraguay,2004,4,10,5,5,0.174400002
PAR,150.2005,150,Paraguay,2005,4,10,5,5,0.123099998
PAR,150.2006,150,Paraguay,2006,4,10,5,5,0.095509999
PAR,150.2007,150,Paraguay,2007,4,10,5,5,0.028109999
PAR,150.2008,150,Paraguay,2008,4,9,5,4,-0.034159999
PAR,150.2009,150,Paraguay,2009,4,9,5,4,-0.125400007
PAR,150.201,150,Paraguay,2010,4,8,4,4,-0.092660002
PAR,150.2011,150,Paraguay,2011,4,8,4,4,-0.119000003
PAR,150.2012,150,Paraguay,2012,4,9,4,5,-0.142700002
PAR,150.2013,150,Paraguay,2013,4,9,4,5,-0.118199997
PAR,150.2014,150,Paraguay,2014,4,9,4,5,-0.119900003
PAR,150.2015,150,Paraguay,2015,4,9,4,5,-0.122199997
PAR,150.2016,150,Paraguay,2016,4,9,4,5,NA
PAR,150.2017,150,Paraguay,2017,4,8,4,4,NA
PAR,150.2018,150,Paraguay,2018,4,8,4,4,NA
PHI,840.1995,840,Philippines,1995,3,15,10,5,-0.573700011
PHI,840.1996,840,Philippines,1996,3,15,10,5,-0.646700025
PHI,840.1997,840,Philippines,1997,3,14,9,5,-0.689999998
PHI,840.1998,840,Philippines,1998,3,14,9,5,-0.681400001
PHI,840.1999,840,Philippines,1999,3,14,9,5,-0.65109998
PHI,840.2,840,Philippines,2000,3,12,9,3,-0.503400028
PHI,840.2001,840,Philippines,2001,3,13,9,4,-0.349799991
PHI,840.2002,840,Philippines,2002,3,13,9,4,-0.354400009
PHI,840.2003,840,Philippines,2003,3,13,9,4,-0.376800001
PHI,840.2004,840,Philippines,2004,3,13,9,4,-0.529999971
PHI,840.2005,840,Philippines,2005,3,12,8,4,-0.657000005
PHI,840.2006,840,Philippines,2006,3,12,8,4,-0.537999988
PHI,840.2007,840,Philippines,2007,3,12,8,4,-0.640699983
PHI,840.2008,840,Philippines,2008,3,12,8,4,-0.692099988
PHI,840.2009,840,Philippines,2009,3,12,8,4,-0.685800016
PHI,840.201,840,Philippines,2010,3,11,8,3,-0.708500028
PHI,840.2011,840,Philippines,2011,3,11,8,3,-0.73360002
PHI,840.2012,840,Philippines,2012,3,11,8,3,-0.717700005
PHI,840.2013,840,Philippines,2013,3,11,8,3,-0.774999976
PHI,840.2014,840,Philippines,2014,3,12,8,4,-0.653800011
PHI,840.2015,840,Philippines,2015,3,12,8,4,-0.714600027
PHI,840.2016,840,Philippines,2016,3,12,8,4,NA
PHI,840.2017,840,Philippines,2017,3,12,8,4,NA
PHI,840.2018,840,Philippines,2018,3,14,8,6,NA
PNG,910.1995,910,Papua New Guinea,1995,3,16,7,9,0.331200004
PNG,910.1996,910,Papua New Guinea,1996,3,15,7,8,0.282400012
PNG,910.1997,910,Papua New Guinea,1997,3,15,7,8,0.245700002
PNG,910.1998,910,Papua New Guinea,1998,3,14,7,7,0.207699999
PNG,910.1999,910,Papua New Guinea,1999,3,14,7,7,0.156100005
PNG,910.2,910,Papua New Guinea,2000,3,14,7,7,0.266600013
PNG,910.2001,910,Papua New Guinea,2001,3,14,7,7,0.255699992
PNG,910.2002,910,Papua New Guinea,2002,3,14,7,7,0.288300008
PNG,910.2003,910,Papua New Guinea,2003,3,14,7,7,0.265399992
PNG,910.2004,910,Papua New Guinea,2004,3,14,7,7,0.443899989
PNG,910.2005,910,Papua New Guinea,2005,3,12,5,7,0.319499999
PNG,910.2006,910,Papua New Guinea,2006,3,12,6,6,0.356000006
PNG,910.2007,910,Papua New Guinea,2007,3,11,5,6,0.388099998
PNG,910.2008,910,Papua New Guinea,2008,3,11,5,6,0.394400001
PNG,910.2009,910,Papua New Guinea,2009,3,11,5,6,0.3477
PNG,910.201,910,Papua New Guinea,2010,3,10,5,5,0.4005
PNG,910.2011,910,Papua New Guinea,2011,3,11,6,5,0.405299991
PNG,910.2012,910,Papua New Guinea,2012,3,11,6,5,0.291700006
PNG,910.2013,910,Papua New Guinea,2013,3,11,6,5,0.314500004
PNG,910.2014,910,Papua New Guinea,2014,3,11,6,5,0.194399998
PNG,910.2015,910,Papua New Guinea,2015,3,11,6,5,0.250499994
PNG,910.2016,910,Papua New Guinea,2016,3,11,6,5,NA
PNG,910.2017,910,Papua New Guinea,2017,3,10,5,5,NA
PNG,910.2018,910,Papua New Guinea,2018,3,10,5,5,NA
RWA,517.1995,517,Rwanda,1995,1,22,11,11,0.152099997
RWA,517.1996,517,Rwanda,1996,1,22,11,11,-0.065520003
RWA,517.1997,517,Rwanda,1997,1,22,11,11,-0.04569
RWA,517.1998,517,Rwanda,1998,1,22,11,11,-0.185499996
RWA,517.1999,517,Rwanda,1999,1,22,11,11,-0.210199997
RWA,517.2,517,Rwanda,2000,1,22,11,11,-0.382800013
RWA,517.2001,517,Rwanda,2001,1,22,11,11,-0.430799991
RWA,517.2002,517,Rwanda,2002,1,22,11,11,-0.454100013
RWA,517.2003,517,Rwanda,2003,1,22,11,11,-0.412999988
RWA,517.2004,517,Rwanda,2004,1,20,10,10,-0.301899999
RWA,517.2005,517,Rwanda,2005,1,19,10,9,-0.392399997
RWA,517.2006,517,Rwanda,2006,1,19,10,9,-0.42719999
RWA,517.2007,517,Rwanda,2007,1,19,10,9,-0.522700012
RWA,517.2008,517,Rwanda,2008,1,19,10,9,-0.573499978
RWA,517.2009,517,Rwanda,2009,1,17,9,8,-0.66049999
RWA,517.201,517,Rwanda,2010,1,17,9,8,-0.631200016
RWA,517.2011,517,Rwanda,2011,1,17,9,8,-0.577499986
RWA,517.2012,517,Rwanda,2012,1,17,9,8,-0.711700022
RWA,517.2013,517,Rwanda,2013,1,17,9,8,-0.709299982
RWA,517.2014,517,Rwanda,2014,1,16,8,8,-0.765699983
RWA,517.2015,517,Rwanda,2015,1,16,8,8,-0.752799988
RWA,517.2016,517,Rwanda,2016,1,16,8,8,NA
RWA,517.2017,517,Rwanda,2017,1,16,9,7,NA
RWA,517.2018,517,Rwanda,2018,1,15,8,7,NA
SAF,560.1995,560,South Africa,1995,1,13,6,7,-1.498999953
SAF,560.1996,560,South Africa,1996,1,13,6,7,-1.491999984
SAF,560.1997,560,South Africa,1997,1,13,6,7,-1.381999969
SAF,560.1998,560,South Africa,1998,1,12,5,7,-1.226999998
SAF,560.1999,560,South Africa,1999,1,12,5,7,-1.118000031
SAF,560.2,560,South Africa,2000,1,12,5,7,-1.049000025
SAF,560.2001,560,South Africa,2001,1,12,5,7,-1.039000034
SAF,560.2002,560,South Africa,2002,1,11,5,6,-0.980199993
SAF,560.2003,560,South Africa,2003,1,11,5,6,-0.929899991
SAF,560.2004,560,South Africa,2004,1,10,4,6,-1.129999995
SAF,560.2005,560,South Africa,2005,1,11,5,6,-1.14199996
SAF,560.2006,560,South Africa,2006,1,9,4,5,-1.187000036
SAF,560.2007,560,South Africa,2007,1,8,3,5,-1.203999996
SAF,560.2008,560,South Africa,2008,1,8,3,5,-1.156000018
SAF,560.2009,560,South Africa,2009,1,8,3,5,-1.006000042
SAF,560.201,560,South Africa,2010,1,8,3,5,-1.008999944
SAF,560.2011,560,South Africa,2011,1,7,2,5,-0.972599983
SAF,560.2012,560,South Africa,2012,1,8,3,5,-0.888199985
SAF,560.2013,560,South Africa,2013,1,8,3,5,-0.905300021
SAF,560.2014,560,South Africa,2014,1,8,3,5,-0.826699972
SAF,560.2015,560,South Africa,2015,1,8,3,5,-0.883300006
SAF,560.2016,560,South Africa,2016,1,8,3,5,NA
SAF,560.2017,560,South Africa,2017,1,8,3,5,NA
SAF,560.2018,560,South Africa,2018,1,8,3,5,NA
SAU,670.1995,670,Saudi Arabia,1995,2,10,2,8,0.002362
SAU,670.1996,670,Saudi Arabia,1996,2,10,2,8,0.101899996
SAU,670.1997,670,Saudi Arabia,1997,2,10,2,8,0.023809999
SAU,670.1998,670,Saudi Arabia,1998,2,10,2,8,0.017039999
SAU,670.1999,670,Saudi Arabia,1999,2,11,2,9,0.02581
SAU,670.2,670,Saudi Arabia,2000,2,11,2,9,0.01436
SAU,670.2001,670,Saudi Arabia,2001,2,11,2,9,0.003124
SAU,670.2002,670,Saudi Arabia,2002,2,10,2,8,0.042580001
SAU,670.2003,670,Saudi Arabia,2003,2,10,3,7,0.034990001
SAU,670.2004,670,Saudi Arabia,2004,2,10,3,7,-0.208299994
SAU,670.2005,670,Saudi Arabia,2005,2,7,1,6,-0.807699978
SAU,670.2006,670,Saudi Arabia,2006,2,8,1,7,-0.784300029
SAU,670.2007,670,Saudi Arabia,2007,2,9,1,8,-0.792999983
SAU,670.2008,670,Saudi Arabia,2008,2,10,2,8,-0.78490001
SAU,670.2009,670,Saudi Arabia,2009,2,10,2,8,-0.30219999
SAU,670.201,670,Saudi Arabia,2010,2,10,2,8,-0.236100003
SAU,670.2011,670,Saudi Arabia,2011,2,10,2,8,-0.25150001
SAU,670.2012,670,Saudi Arabia,2012,2,9,1,8,-0.271200001
SAU,670.2013,670,Saudi Arabia,2013,2,9,1,8,-0.455799997
SAU,670.2014,670,Saudi Arabia,2014,2,9,1,8,-0.421200007
SAU,670.2015,670,Saudi Arabia,2015,2,8,0,8,-0.407799989
SAU,670.2016,670,Saudi Arabia,2016,2,8,0,8,NA
SAU,670.2017,670,Saudi Arabia,2017,2,8,0,8,NA
SAU,670.2018,670,Saudi Arabia,2018,2,8,0,8,NA
SIE,451.1995,451,Sierra Leone,1995,1,23,11,12,1.743999958
SIE,451.1996,451,Sierra Leone,1996,1,24,12,12,1.521999955
SIE,451.1997,451,Sierra Leone,1997,1,24,12,12,1.577999949
SIE,451.1998,451,Sierra Leone,1998,1,24,12,12,1.516000032
SIE,451.1999,451,Sierra Leone,1999,1,24,12,12,1.394000053
SIE,451.2,451,Sierra Leone,2000,1,24,12,12,1.291000009
SIE,451.2001,451,Sierra Leone,2001,1,24,12,12,1.228999972
SIE,451.2002,451,Sierra Leone,2002,1,22,12,10,0.913399994
SIE,451.2003,451,Sierra Leone,2003,1,23,12,11,0.724099994
SIE,451.2004,451,Sierra Leone,2004,1,22,12,10,0.996299982
SIE,451.2005,451,Sierra Leone,2005,1,22,12,10,0.701799989
SIE,451.2006,451,Sierra Leone,2006,1,22,12,10,0.649299979
SIE,451.2007,451,Sierra Leone,2007,1,20,12,8,0.636500001
SIE,451.2008,451,Sierra Leone,2008,1,20,12,8,0.554199994
SIE,451.2009,451,Sierra Leone,2009,1,19,11,8,0.379700005
SIE,451.201,451,Sierra Leone,2010,1,19,11,8,0.335399985
SIE,451.2011,451,Sierra Leone,2011,1,19,11,8,0.329699993
SIE,451.2012,451,Sierra Leone,2012,1,17,9,8,0.1646
SIE,451.2013,451,Sierra Leone,2013,1,14,7,7,0.07722
SIE,451.2014,451,Sierra Leone,2014,1,14,7,7,0.078299999
SIE,451.2015,451,Sierra Leone,2015,1,14,7,7,0.070210002
SIE,451.2016,451,Sierra Leone,2016,1,13,6,7,NA
SIE,451.2017,451,Sierra Leone,2017,1,13,6,7,NA
SIE,451.2018,451,Sierra Leone,2018,1,13,6,7,NA
SIN,830.1995,830,Singapore,1995,3,2,0,2,-1.753000021
SIN,830.1996,830,Singapore,1996,3,2,0,2,-1.763000011
SIN,830.1997,830,Singapore,1997,3,2,0,2,-1.748999953
SIN,830.1998,830,Singapore,1998,3,2,0,2,-1.782999992
SIN,830.1999,830,Singapore,1999,3,2,0,2,-1.786000013
SIN,830.2,830,Singapore,2000,3,2,0,2,-1.799000025
SIN,830.2001,830,Singapore,2001,3,2,0,2,-1.812999964
SIN,830.2002,830,Singapore,2002,3,2,0,2,-1.771000028
SIN,830.2003,830,Singapore,2003,3,3,1,2,-1.671000004
SIN,830.2004,830,Singapore,2004,3,2,0,2,-1.631999969
SIN,830.2005,830,Singapore,2005,3,2,0,2,-1.661999941
SIN,830.2006,830,Singapore,2006,3,2,0,2,-1.633999944
SIN,830.2007,830,Singapore,2007,3,2,0,2,-1.621999979
SIN,830.2008,830,Singapore,2008,3,2,0,2,-1.690000057
SIN,830.2009,830,Singapore,2009,3,2,0,2,-1.644000053
SIN,830.201,830,Singapore,2010,3,2,0,2,-1.639999986
SIN,830.2011,830,Singapore,2011,3,2,0,2,-1.654999971
SIN,830.2012,830,Singapore,2012,3,2,0,2,-1.65199995
SIN,830.2013,830,Singapore,2013,3,2,0,2,-1.672000051
SIN,830.2014,830,Singapore,2014,3,2,0,2,-1.674999952
SIN,830.2015,830,Singapore,2015,3,2,0,2,-1.672000051
SIN,830.2016,830,Singapore,2016,3,2,0,2,NA
SIN,830.2017,830,Singapore,2017,3,3,1,2,NA
SIN,830.2018,830,Singapore,2018,3,3,1,2,NA
SOM,520.1995,520,Somalia,1995,2,24,12,12,1.690999985
SOM,520.1996,520,Somalia,1996,2,24,12,12,1.625
SOM,520.1997,520,Somalia,1997,2,23,12,11,1.621000051
SOM,520.1998,520,Somalia,1998,2,23,12,11,1.628999949
SOM,520.1999,520,Somalia,1999,2,23,12,11,1.705000043
SOM,520.2,520,Somalia,2000,2,23,12,11,1.702999949
SOM,520.2001,520,Somalia,2001,2,23,12,11,1.74000001
SOM,520.2002,520,Somalia,2002,2,23,12,11,1.80400002
SOM,520.2003,520,Somalia,2003,2,23,12,11,1.804999948
SOM,520.2004,520,Somalia,2004,2,23,12,11,2.059000015
SOM,520.2005,520,Somalia,2005,2,23,12,11,2.117000103
SOM,520.2006,520,Somalia,2006,2,23,12,11,2.309999943
SOM,520.2007,520,Somalia,2007,2,24,12,12,2.220000029
SOM,520.2008,520,Somalia,2008,2,25,13,12,2.275000095
SOM,520.2009,520,Somalia,2009,2,25,13,12,2.223999977
SOM,520.201,520,Somalia,2010,2,24,12,12,2.247999907
SOM,520.2011,520,Somalia,2011,2,24,12,12,2.309000015
SOM,520.2012,520,Somalia,2012,2,20,10,10,2.141000032
SOM,520.2013,520,Somalia,2013,2,20,10,10,2.068000078
SOM,520.2014,520,Somalia,2014,2,20,10,10,2.092999935
SOM,520.2015,520,Somalia,2015,2,20,10,10,2.095999956
SOM,520.2016,520,Somalia,2016,2,20,10,10,NA
SOM,520.2017,520,Somalia,2017,2,20,10,10,NA
SOM,520.2018,520,Somalia,2018,2,20,10,10,NA
SYR,652.1995,652,Syria,1995,2,14,6,8,-0.267100006
SYR,652.1996,652,Syria,1996,2,15,6,9,-0.303000003
SYR,652.1997,652,Syria,1997,2,15,6,9,-0.402799994
SYR,652.1998,652,Syria,1998,2,15,6,9,-0.308899999
SYR,652.1999,652,Syria,1999,2,14,6,8,-0.369700015
SYR,652.2,652,Syria,2000,2,13,5,8,-0.400000006
SYR,652.2001,652,Syria,2001,2,13,5,8,-0.288500011
SYR,652.2002,652,Syria,2002,2,12,4,8,-0.305500001
SYR,652.2003,652,Syria,2003,2,11,4,7,-0.267699987
SYR,652.2004,652,Syria,2004,2,11,4,7,-0.160699993
SYR,652.2005,652,Syria,2005,2,11,3,8,-0.191699997
SYR,652.2006,652,Syria,2006,2,10,3,7,-0.247400001
SYR,652.2007,652,Syria,2007,2,10,3,7,-0.215700001
SYR,652.2008,652,Syria,2008,2,11,3,8,-0.407799989
SYR,652.2009,652,Syria,2009,2,10,3,7,-0.325800002
SYR,652.201,652,Syria,2010,2,10,3,7,-0.207800001
SYR,652.2011,652,Syria,2011,2,12,4,8,-0.1096
SYR,652.2012,652,Syria,2012,2,13,5,8,0.352200001
SYR,652.2013,652,Syria,2013,2,15,7,8,1.034999967
SYR,652.2014,652,Syria,2014,2,17,8,9,1.220000029
SYR,652.2015,652,Syria,2015,2,16,9,7,1.202000022
SYR,652.2016,652,Syria,2016,2,15,8,7,NA
SYR,652.2017,652,Syria,2017,2,15,8,7,NA
SYR,652.2018,652,Syria,2018,2,14,7,7,NA
TAZ,510.1995,510,Tanzania,1995,1,15,9,6,0.04809
TAZ,510.1996,510,Tanzania,1996,1,16,9,7,-0.1259
TAZ,510.1997,510,Tanzania,1997,1,16,9,7,-0.108599998
TAZ,510.1998,510,Tanzania,1998,1,15,9,6,-0.07903
TAZ,510.1999,510,Tanzania,1999,1,15,9,6,-0.04118
TAZ,510.2,510,Tanzania,2000,1,15,9,6,-0.082599998
TAZ,510.2001,510,Tanzania,2001,1,15,9,6,-0.044670001
TAZ,510.2002,510,Tanzania,2002,1,15,9,6,-0.056809999
TAZ,510.2003,510,Tanzania,2003,1,14,8,6,-0.07858
TAZ,510.2004,510,Tanzania,2004,1,14,8,6,-0.113899998
TAZ,510.2005,510,Tanzania,2005,1,12,6,6,-0.236000001
TAZ,510.2006,510,Tanzania,2006,1,11,6,5,-0.185399994
TAZ,510.2007,510,Tanzania,2007,1,11,6,5,-0.27700001
TAZ,510.2008,510,Tanzania,2008,1,11,6,5,-0.334600002
TAZ,510.2009,510,Tanzania,2009,1,12,6,6,-0.2764
TAZ,510.201,510,Tanzania,2010,1,12,6,6,-0.237200007
TAZ,510.2011,510,Tanzania,2011,1,11,6,5,-0.269899994
TAZ,510.2012,510,Tanzania,2012,1,11,6,5,-0.289099991
TAZ,510.2013,510,Tanzania,2013,1,10,6,4,-0.339899987
TAZ,510.2014,510,Tanzania,2014,1,9,6,3,-0.350199997
TAZ,510.2015,510,Tanzania,2015,1,11,7,4,-0.377600014
TAZ,510.2016,510,Tanzania,2016,1,10,6,4,NA
TAZ,510.2017,510,Tanzania,2017,1,10,6,4,NA
TAZ,510.2018,510,Tanzania,2018,1,10,6,4,NA
TOG,461.1995,461,Togo,1995,1,20,10,10,0.392199993
TOG,461.1996,461,Togo,1996,1,19,10,9,0.494800001
TOG,461.1997,461,Togo,1997,1,19,10,9,0.523899972
TOG,461.1998,461,Togo,1998,1,18,10,8,0.529100001
TOG,461.1999,461,Togo,1999,1,17,10,7,0.486200005
TOG,461.2,461,Togo,2000,1,16,10,6,0.465799987
TOG,461.2001,461,Togo,2001,1,16,10,6,0.456800014
TOG,461.2002,461,Togo,2002,1,16,10,6,0.498400003
TOG,461.2003,461,Togo,2003,1,16,10,6,0.409299999
TOG,461.2004,461,Togo,2004,1,16,10,6,0.467200011
TOG,461.2005,461,Togo,2005,1,16,8,8,0.751800001
TOG,461.2006,461,Togo,2006,1,13,7,6,0.531300008
TOG,461.2007,461,Togo,2007,1,13,7,6,0.497599989
TOG,461.2008,461,Togo,2008,1,13,7,6,0.594600022
TOG,461.2009,461,Togo,2009,1,13,7,6,0.530499995
TOG,461.201,461,Togo,2010,1,13,7,6,0.487699986
TOG,461.2011,461,Togo,2011,1,13,7,6,0.362699986
TOG,461.2012,461,Togo,2012,1,13,7,6,0.33039999
TOG,461.2013,461,Togo,2013,1,13,7,6,0.270300001
TOG,461.2014,461,Togo,2014,1,13,7,6,0.231800005
TOG,461.2015,461,Togo,2015,1,13,7,6,0.193499997
TOG,461.2016,461,Togo,2016,1,13,7,6,NA
TOG,461.2017,461,Togo,2017,1,12,7,5,NA
TOG,461.2018,461,Togo,2018,1,13,8,5,NA
TUR,640.1995,640,Turkey,1995,2,12,4,8,-1.039999962
TUR,640.1996,640,Turkey,1996,2,12,4,8,-1.042000055
TUR,640.1997,640,Turkey,1997,2,11,4,7,-0.995500028
TUR,640.1998,640,Turkey,1998,2,12,4,8,-1.003000021
TUR,640.1999,640,Turkey,1999,2,11,4,7,-0.954900026
TUR,640.2,640,Turkey,2000,2,11,4,7,-1.014999986
TUR,640.2001,640,Turkey,2001,2,11,4,7,-1.014999986
TUR,640.2002,640,Turkey,2002,2,11,4,7,-1.18900001
TUR,640.2003,640,Turkey,2003,2,10,4,6,-1.235999942
TUR,640.2004,640,Turkey,2004,2,10,4,6,-1.200999975
TUR,640.2005,640,Turkey,2005,2,10,4,6,-1.220999956
TUR,640.2006,640,Turkey,2006,2,9,3,6,-1.167000055
TUR,640.2007,640,Turkey,2007,2,8,3,5,-1.378000021
TUR,640.2008,640,Turkey,2008,2,9,3,6,-1.394999981
TUR,640.2009,640,Turkey,2009,2,10,4,6,-1.432999969
TUR,640.201,640,Turkey,2010,2,9,3,6,-1.360000014
TUR,640.2011,640,Turkey,2011,2,8,3,5,-1.343000054
TUR,640.2012,640,Turkey,2012,2,7,3,4,-1.338000059
TUR,640.2013,640,Turkey,2013,2,8,3,5,-1.279999971
TUR,640.2014,640,Turkey,2014,2,7,3,4,-1.100999951
TUR,640.2015,640,Turkey,2015,2,9,4,5,-1.003999949
TUR,640.2016,640,Turkey,2016,2,9,5,4,NA
TUR,640.2017,640,Turkey,2017,2,9,5,4,NA
TUR,640.2018,640,Turkey,2018,2,9,5,4,NA
UGA,500.1995,500,Uganda,1995,1,21,12,9,0.167600006
UGA,500.1996,500,Uganda,1996,1,20,12,8,-0.01902
UGA,500.1997,500,Uganda,1997,1,20,12,8,-0.108900003
UGA,500.1998,500,Uganda,1998,1,21,12,9,-0.1435
UGA,500.1999,500,Uganda,1999,1,21,12,9,-0.163499996
UGA,500.2,500,Uganda,2000,1,21,12,9,-0.109300002
UGA,500.2001,500,Uganda,2001,1,21,12,9,-0.096220002
UGA,500.2002,500,Uganda,2002,1,19,11,8,-0.152899995
UGA,500.2003,500,Uganda,2003,1,17,9,8,-0.121299997
UGA,500.2004,500,Uganda,2004,1,16,9,7,-0.042950001
UGA,500.2005,500,Uganda,2005,1,17,9,8,-0.280299991
UGA,500.2006,500,Uganda,2006,1,16,9,7,-0.152099997
UGA,500.2007,500,Uganda,2007,1,17,9,8,-0.218799993
UGA,500.2008,500,Uganda,2008,1,16,9,7,-0.237499997
UGA,500.2009,500,Uganda,2009,1,16,9,7,-0.203500003
UGA,500.201,500,Uganda,2010,1,17,10,7,-0.351900011
UGA,500.2011,500,Uganda,2011,1,17,10,7,-0.379200011
UGA,500.2012,500,Uganda,2012,1,17,10,7,-0.320499986
UGA,500.2013,500,Uganda,2013,1,18,11,7,-0.342400014
UGA,500.2014,500,Uganda,2014,1,18,11,7,-0.282400012
UGA,500.2015,500,Uganda,2015,1,17,10,7,-0.369100004
UGA,500.2016,500,Uganda,2016,1,16,9,7,NA
UGA,500.2017,500,Uganda,2017,1,14,9,5,NA
UGA,500.2018,500,Uganda,2018,1,14,9,5,NA
URU,165.1995,165,Uruguay,1995,4,2,1,1,-0.986100018
URU,165.1996,165,Uruguay,1996,4,1,1,0,-1.157999992
URU,165.1997,165,Uruguay,1997,4,1,1,0,-1.200000048
URU,165.1998,165,Uruguay,1998,4,1,1,0,-1.197999954
URU,165.1999,165,Uruguay,1999,4,1,1,0,-1.217000008
URU,165.2,165,Uruguay,2000,4,1,1,0,-1.215999961
URU,165.2001,165,Uruguay,2001,4,1,1,0,-1.156000018
URU,165.2002,165,Uruguay,2002,4,2,1,1,-1.075000048
URU,165.2003,165,Uruguay,2003,4,2,1,1,-1.065999985
URU,165.2004,165,Uruguay,2004,4,2,1,1,-1.093999982
URU,165.2005,165,Uruguay,2005,4,2,1,1,-1.161999941
URU,165.2006,165,Uruguay,2006,4,2,1,1,-1.271000028
URU,165.2007,165,Uruguay,2007,4,2,1,1,-1.271999955
URU,165.2008,165,Uruguay,2008,4,2,1,1,-1.355000019
URU,165.2009,165,Uruguay,2009,4,3,1,2,-1.355999947
URU,165.201,165,Uruguay,2010,4,3,1,2,-1.422000051
URU,165.2011,165,Uruguay,2011,4,3,1,2,-1.404000044
URU,165.2012,165,Uruguay,2012,4,3,1,2,-1.414000034
URU,165.2013,165,Uruguay,2013,4,2,0,2,-1.32099998
URU,165.2014,165,Uruguay,2014,4,2,0,2,-1.338999987
URU,165.2015,165,Uruguay,2015,4,2,0,2,-1.292999983
URU,165.2016,165,Uruguay,2016,4,2,0,2,NA
URU,165.2017,165,Uruguay,2017,4,2,0,2,NA
URU,165.2018,165,Uruguay,2018,4,2,0,2,NA
VEN,101.1995,101,Venezuela,1995,4,9,3,6,-0.344599992
VEN,101.1996,101,Venezuela,1996,4,9,3,6,-0.296200007
VEN,101.1997,101,Venezuela,1997,4,9,3,6,-0.352800012
VEN,101.1998,101,Venezuela,1998,4,9,3,6,-0.264299989
VEN,101.1999,101,Venezuela,1999,4,9,3,6,-0.276600003
VEN,101.2,101,Venezuela,2000,4,9,3,6,-0.159899995
VEN,101.2001,101,Venezuela,2001,4,10,3,7,-0.186100006
VEN,101.2002,101,Venezuela,2002,4,11,4,7,-0.003318
VEN,101.2003,101,Venezuela,2003,4,11,4,7,0.114399999
VEN,101.2004,101,Venezuela,2004,4,11,4,7,-0.200200006
VEN,101.2005,101,Venezuela,2005,4,11,4,7,-0.318300009
VEN,101.2006,101,Venezuela,2006,4,11,3,8,-0.33860001
VEN,101.2007,101,Venezuela,2007,4,10,2,8,-0.364499986
VEN,101.2008,101,Venezuela,2008,4,10,2,8,-0.416200012
VEN,101.2009,101,Venezuela,2009,4,11,3,8,-0.287299991
VEN,101.201,101,Venezuela,2010,4,11,3,8,-0.161699995
VEN,101.2011,101,Venezuela,2011,4,10,3,7,-0.071769997
VEN,101.2012,101,Venezuela,2012,4,12,4,8,-0.054869998
VEN,101.2013,101,Venezuela,2013,4,10,3,7,-0.03562
VEN,101.2014,101,Venezuela,2014,4,11,4,7,-0.01461
VEN,101.2015,101,Venezuela,2015,4,11,4,7,0.02595
VEN,101.2016,101,Venezuela,2016,4,11,4,7,NA
VEN,101.2017,101,Venezuela,2017,4,12,4,8,NA
VEN,101.2018,101,Venezuela,2018,4,14,5,9,NA
ZAI,490.1995,490,Dem. Rep. of Congo,1995,1,23,11,12,1.24000001
ZAI,490.1996,490,Dem. Rep. of Congo,1996,1,24,12,12,1.427000046
ZAI,490.1997,490,Dem. Rep. of Congo,1997,1,24,12,12,1.34800005
ZAI,490.1998,490,Dem. Rep. of Congo,1998,1,24,12,12,1.309000015
ZAI,490.1999,490,Dem. Rep. of Congo,1999,1,24,12,12,1.345999956
ZAI,490.2,490,Dem. Rep. of Congo,2000,1,24,12,12,1.105999947
ZAI,490.2001,490,Dem. Rep. of Congo,2001,1,24,12,12,0.993300021
ZAI,490.2002,490,Dem. Rep. of Congo,2002,1,24,12,12,0.981700003
ZAI,490.2003,490,Dem. Rep. of Congo,2003,1,22,11,11,1.213000059
ZAI,490.2004,490,Dem. Rep. of Congo,2004,1,23,12,11,1.450999975
ZAI,490.2005,490,Dem. Rep. of Congo,2005,1,23,12,11,1.396000028
ZAI,490.2006,490,Dem. Rep. of Congo,2006,1,23,12,11,1.473999977
ZAI,490.2007,490,Dem. Rep. of Congo,2007,1,22,12,10,1.478000045
ZAI,490.2008,490,Dem. Rep. of Congo,2008,1,23,12,11,1.478999972
ZAI,490.2009,490,Dem. Rep. of Congo,2009,1,23,12,11,1.585999966
ZAI,490.201,490,Dem. Rep. of Congo,2010,1,23,12,11,1.536999941
ZAI,490.2011,490,Dem. Rep. of Congo,2011,1,23,12,11,1.31099999
ZAI,490.2012,490,Dem. Rep. of Congo,2012,1,23,12,11,1.271999955
ZAI,490.2013,490,Dem. Rep. of Congo,2013,1,23,13,10,1.172999978
ZAI,490.2014,490,Dem. Rep. of Congo,2014,1,23,13,10,1.059000015
ZAI,490.2015,490,Dem. Rep. of Congo,2015,1,23,13,10,0.99119997
ZAI,490.2016,490,Dem. Rep. of Congo,2016,1,24,13,11,NA
ZAI,490.2017,490,Dem. Rep. of Congo,2017,1,24,13,11,NA
ZAI,490.2018,490,Dem. Rep. of Congo,2018,1,24,13,11,NA
